"","ASV","YSI","rASV","rYSI","means"
"0003841008",0.0352514599532251,1771,48,1723,160.553768654667
"0003841014",2.11670287695761,3078,2083,995,171.679545558465
"0003841017",0.906897267552893,1795,1194,601,177.140186798453
"0003841020",0.834860140889701,2740,1107,1633,162.443124587311
"0003841027",0.907471169041331,3306,1195,2111,141.728103368042
"0005041004",0.24452657771988,267,245,22,198.403613274893
"0005041009",2.4745074088332,3295,2139,1156,169.55986490366
"0005041016",1.37638693054993,3188,1685,1503,164.753769366014
"0005041017",0.221491101962104,1260,218,1042,171.031501746882
"0005041033",0.985113210720689,1512,1297,215,185.634860085785
"0007341014",0.218227388500336,1865,214,1651,162.185117624007
"0007341022",0.359357953397266,1464,378,1086,170.477934738882
"0007341031",0.502945079760997,2305,613,1692,161.269007150302
"0007341035",0.598982438093783,2023,745,1278,167.690379115097
"0007341049",1.57472388777819,2716,1854,862,173.3721090641
"0011021002",0.178847344549539,349,166,183,186.6696006775
"0011021021",0.832763054876392,2708,1101,1607,162.830494236912
"0011021044",0.278161422102565,953,276,677,175.951098710507
"0011021048",0.89900125977308,3150,1180,1970,152.583222471224
"0011221016",1.54193219440009,2070,1830,240,184.757119049672
"0011221025",2.20047967804916,3098,2107,991,171.75082458734
"0011221029",1.64210858730937,2993,1888,1105,170.219384671327
"0011221045",0.669100846223429,1714,848,866,173.303874587339
"0011221046",1.49922735283241,2101,1797,304,183.029319411381
"0011421008",1.34977602422034,2409,1659,750,174.77994645918
"0011421022",0.147392192470268,201,128,73,192.550366225396
"0011421024",0.96553785604973,3151,1269,1882,156.475986025658
"0011421027",0.138851250814896,1525,121,1404,166.140728130165
"0011421052",0.0936279564038781,1091,81,1010,171.480491543279
"0012621023",1.45328658544968,2800,1752,1048,170.983179067404
"0012621024",0.96693187156503,3145,1274,1871,156.695894882403
"0012621029",0.731898683303993,3022,936,2086,145.123048590043
"0012621073",0.50874557882649,1924,619,1305,167.30890173361
"0012621074",0.511487300722855,1157,623,534,178.377895289841
"0013721007",5.34085412766368e-13,1960,26,1934,154.361583990914
"0013721013",5.48924877284329e-13,2144,27,2117,141.395410541234
"0013721019",1.41040147450953,2088,1719,369,181.33463496594
"0013721075",1.52278285870302,3914,1816,2098,143.550248740404
"0013721080",0.0211731297638604,1511,44,1467,165.233014065728
"0017721035",0.550243305346487,1727,672,1055,170.898745245891
"0017721041",1.56100431600216,2747,1844,903,172.856042970214
"0017721049",2.03879557673279,3749,2062,1687,161.348780774972
"0017721050",0.381833545538231,1930,407,1523,164.291953602448
"0017721052",4.08277049393102,3349,2195,1154,169.570782643086
"0018021002",1.02889628150522,1625,1341,284,183.648049727188
"0018021004",0.338224535039165,578,348,230,185.007393965602
"0018021027",0.407715174949086,2188,448,1740,160.178646159124
"0018021045",1.39922735253762,2749,1709,1040,171.034789817933
"0018021046",0.492061967567895,1158,586,572,177.540632282769
"0019021004",0.817948056682777,2420,1080,1340,166.819337352551
"0019021017",0.816469646359028,3078,1078,2000,151.039310611008
"0019021029",0.987891965076892,2438,1301,1137,169.743920353139
"0019021033",1.23502661150438,2445,1546,899,172.890240329368
"0019021038",1.15410436330496,2155,1463,692,175.751793958578
"0019421009",0.631436877047205,1212,789,423,180.314940063813
"0019421016",0.787890555042149,2755,1030,1725,160.512982829689
"0019421027",1.77753301111121,3979,1952,2027,149.408532440094
"0019421029",0.748202412959505,1841,961,880,173.13161111271
"0019421030",0.433145321093693,2482,489,1993,151.515886450303
"0022821001",1.30040202089734,2774,1612,1162,169.48147527243
"0022821002",3.36475566371586,2616,2190,426,180.273747323809
"0022821004",0.586362074179668,768,730,38,195.58522456579
"0022821017",0.708651650810114,1528,897,631,176.617350842301
"0022821031",0.740377458246851,1770,948,822,173.791276750044
"0028421003",0.238253695865569,1696,235,1461,165.306902664825
"0028421008",0.892542834894637,2793,1175,1618,162.61347490265
"0028421019",0.567947849006534,880,704,176,186.938347631108
"0028421026",1.14880620173223,1942,1455,487,179.260815928353
"0028421027",0.345682588101269,1058,357,701,175.63186043311
"0028721006",0.646186052437728,2699,819,1880,156.517994768391
"0028721009",0.0135560723857494,2193,42,2151,133.444780889593
"0028721010",0.317625247113174,1826,322,1504,164.743588404854
"0028721011",1.93118409854896,3092,2019,1073,170.669035026455
"0028721015",1.23598021580956,3292,1548,1744,160.120707410588
"0028921005",0.278018973889764,2432,275,2157,130.338978682314
"0028921023",0.466756584115945,2578,539,2039,148.872060357153
"0028921032",0.501566183007976,1512,607,905,172.835575901175
"0028921038",0.377116002612437,2410,395,2015,149.99083642481
"0028921039",0.746993782409801,3098,957,2141,136.225206995874
"0030021064",1.15274949898904,1628,1462,166,187.558413538559
"0030021065",0.365732460676748,1867,383,1484,164.956876752613
"0030021069",1.08211926099045,3025,1389,1636,162.407749771115
"0030021070",1.39850629266523,2386,1708,678,175.94518770494
"0030021074",0.20854099076777,257,196,61,193.667975402216
"0030321024",0.322007809302521,2297,328,1969,152.606078574633
"0030321026",0.495706241331182,2704,592,2112,141.723376932957
"0030321027",0.358273546364033,2351,376,1975,152.435502108952
"0030321042",0.91685297001735,3180,1209,1971,152.554044895916
"0030321057",0.834236033066183,3192,1105,2087,145.067068458197
"0030821002",0.100881443619927,2225,91,2134,137.516208203059
"0030821003",2.1058934204861,3847,2080,1767,159.54695138776
"0030821011",0.765424256969235,1214,990,224,185.197060155346
"0030821034",2.16086231937185,3900,2096,1804,158.510799492565
"0030821036",0.722949568043365,1282,918,364,181.437610278969
"0031221003",0.0565624521477442,2064,59,2005,150.742377010048
"0031221016",1.30813013893828,2455,1618,837,173.602774504067
"0031221032",0.555731032825446,1690,682,1008,171.505199245313
"0031221033",0.114300280461623,1393,103,1290,167.465496717264
"0031221042",1.02410968756015,2158,1334,824,173.770035948012
"0032421006",0.944729106051183,2069,1238,831,173.705086482696
"0032421008",1.22858694627126,3545,1541,2004,150.748356917382
"0032421010",0.141843844313211,552,124,428,180.228442262526
"0032421017",0.436222176209563,1576,495,1081,170.593905424064
"0032421037",0.354457817565083,2158,370,1788,158.874555620876
"0033141005",1.40148401336692,1928,1711,217,185.611171099866
"0033141011",1.71072300692893,3367,1921,1446,165.477415058127
"0033141012",5.31330010627422e-13,286,25,261,184.111503239173
"0033141027",0.234034488142441,2078,226,1852,157.243554327138
"0033141033",0.998209523274198,3198,1306,1892,155.946069172816
"0034441004",1.52761945242271,2057,1821,236,184.854927121598
"0034441008",0.165251921139082,338,142,196,186.371390193853
"0034441036",0.108065294558452,300,100,200,186.250198628755
"0034441069",1.47572677553917,2054,1774,280,183.69347162653
"0034441076",0.787502955964159,1390,1029,361,181.497448214525
"0039941039",3.59487081807514e-13,276,8,268,183.835507759584
"0039941048",0.462390046972842,1036,531,505,178.955285482263
"0039941049",1.20670875280578e-12,2229,33,2196,38.4021512379104
"0039941060",5.92272578576052e-13,348,30,318,182.535507759596
"0040841015",1.06142382167209,3472,1367,2105,142.605374783292
"0040841034",0.877119697584446,1893,1152,741,174.895654978653
"0040841041",1.29410776127196,2540,1606,934,172.508648849536
"0040841069",0.500805293250123,1351,602,749,174.784066641863
"0040841072",1.92218656660348,3862,2016,1846,157.354227245845
"0040941001",0.897335694219694,1268,1179,89,191.877027693062
"0040941014",0.762014130619429,2242,982,1260,168.010007466587
"0040941022",1.18506709085312,2559,1495,1064,170.794992515031
"0040941026",0.334561649482376,1516,340,1176,169.343555792206
"0040941043",1.05381139442697,2122,1359,763,174.643009830004
"0045641014",0.769133418305034,1646,995,651,176.358117926219
"0045641021",0.922878644178774,2138,1216,922,172.612795380923
"0045641027",0.504336182491969,657,614,43,194.823305326673
"0045641040",0.747635611551171,1504,958,546,178.080863026465
"0045641044",0.841278899151254,1480,1115,365,181.430567501734
"0050041001",0.306452640026115,892,313,579,177.466069446629
"0050041016",1.52130306838055,3809,1813,1996,151.239349598248
"0050041018",1.24787319731746,3403,1558,1845,157.399083836393
"0050041022",2.79417355485029,2348,2170,178,186.926021535328
"0050041029",1.28333965911264,3334,1597,1737,160.21555687944
"0052941007",2.05126055197876,3265,2067,1198,168.957098264271
"0052941009",1.41929451597655,2394,1728,666,176.093953277826
"0052941021",2.01855773770774,2857,2054,803,174.047618063749
"0053641021",0.562333387915192,1694,694,1000,171.611366266015
"0053641022",1.41042933395038,2045,1720,325,182.368460164828
"0053641026",1.29758575249783,2519,1609,910,172.761710211373
"0053641055",0.149833503844464,274,132,142,188.737718917624
"0055641048",0.807950231014041,3217,1063,2154,132.818500728525
"0055641053",0.571124522979726,2884,708,2176,124.819070725465
"0055641067",0.368300347652774,2465,389,2076,146.144821972532
"0055641071",0.881730488287074,1948,1159,789,174.210907499302
"0055641074",2.71859376941403,2770,2162,608,176.961051708177
"0056941006",1.1501152892087,1839,1459,380,181.136981956098
"0056941026",0.975479265867959,1634,1282,352,181.717097533054
"0056941032",2.12186749522901,3669,2085,1584,163.269916295916
"0056941040",0.956571971297172,1467,1253,214,185.652296844588
"0060041002",0.0978614572008135,287,84,203,186.122105286939
"0060041010",1.75105004604407,2249,1940,309,182.732330848963
"0060041021",1.31111749306882,3370,1622,1748,160.032981873546
"0060041031",2.59915575043486,2295,2152,143,188.706139568104
"0060041033",0.448609658307898,1585,509,1076,170.66302398642
"0060341036",0.140198542883081,527,122,405,180.636415725999
"0060341048",0.43528320368861,1520,492,1028,171.22674428315
"0060341050",1.04456149259798,2862,1353,1509,164.659439513836
"0060341053",0.860805297334071,1724,1139,585,177.351398512275
"0060341059",0.46530600079313,886,535,351,181.71768506827
"0060641013",3.94996503509804e-13,140,10,130,189.362376256775
"0060641020",0.908077407594878,2600,1197,1403,166.144171284684
"0060641028",1.28287495558951,3439,1596,1843,157.417584622498
"0060641033",0.534581446394313,972,656,316,182.583964228307
"0065221010",0.237682848022053,2424,234,2190,91.0931779995718
"0065221014",0.945292525229225,2106,1239,867,173.278445047352
"0065221015",0.60530916250902,1035,754,281,183.690806290952
"0065221016",0.720845186268512,2586,915,1671,161.677631804951
"0065521002",1.33667045514809,2518,1646,872,173.233072971011
"0065521017",0.377245541363795,1197,396,801,174.072753304612
"0065521045",1.36759168304672,2520,1674,846,173.515015550556
"0065521051",1.00320599521145,3238,1315,1923,154.861778560621
"0065721003",0.29011621927061,2226,295,1931,154.528566884291
"0065721004",0.256812662580207,1307,256,1051,170.951528154054
"0065721006",1.67646274442864,2975,1907,1068,170.715150641626
"0065721007",0.892441880106055,1954,1174,780,174.330711226318
"0065721008",0.96995461715696,2399,1277,1122,169.969058566672
"0065921009",0.446768981214533,884,503,381,181.111685192799
"0065921022",1.96926550534601,3260,2039,1221,168.664618326018
"0065921026",0.737956851451001,1830,944,886,173.0151798347
"0065921027",0.35201377358198,2082,367,1715,160.690739149132
"0065921029",0.339442804664289,1346,352,994,171.680040068765
"0068721001",1.84441751499732,2514,1988,526,178.517288389499
"0068721011",3.23055219822196,3694,2187,1507,164.696249184848
"0068721014",2.98799186999164,3508,2180,1328,166.979714717704
"0068721036",0.789303984914381,1471,1032,439,180.106655087762
"0068721041",0.543993272516137,1061,665,396,180.779586262946
"0069021011",0.718032829042053,2464,912,1552,163.910105286937
"0069021019",3.97016751654321e-13,2198,11,2187,102.502151237937
"0069021033",4.26235872288847e-13,68,17,51,194.301583990906
"0069021089",4.97593798987418e-13,2023,20,2003,150.750410541234
"0069821012",2.15269783388743,3762,2094,1668,161.713058696464
"0069821015",0.342679907896428,685,356,329,182.308221585073
"0069821034",0.954898803461299,2455,1251,1204,168.882693313971
"0069821039",0.838467798454061,1546,1113,433,180.158870118438
"0069821052",2.05935210999281,3600,2071,1529,164.267785054065
"0070021011",1.28174357403788,1872,1595,277,183.704134868347
"0070021017",1.78492027846253,3816,1958,1858,157.002756616136
"0070021030",0.61352538755436,2294,760,1534,164.207714882339
"0070021084",0.393574981193554,2466,429,2037,148.997878162406
"0070021085",0.900553055121717,3247,1184,2063,147.24008196051
"0071821005",0.962009100667142,1631,1264,367,181.383464028807
"0071821008",1.24256612192912,1883,1553,330,182.239560859686
"0071821011",1.19615435594383,2820,1504,1316,167.197431021874
"0071821018",1.23764599631743,1762,1550,212,185.679316035955
"0071821041",1.20218793671643,3354,1512,1842,157.437372270872
"0071921003",1.19553079555147,2161,1501,660,176.233249271264
"0071921010",0.731065979620307,2914,935,1979,152.325771896591
"0071921023",0.214771559853891,1830,207,1623,162.575888750778
"0071921032",0.850672422515095,2181,1124,1057,170.897034626968
"0072421055",2.02743069962037,2897,2056,841,173.552253686474
"0072421057",1.27192321563638,2924,1585,1339,166.862779826657
"0072421058",1.72526510021475,2503,1930,573,177.533013024211
"0072421064",0.581942353133182,2904,721,2183,116.304813200271
"0072421066",2.75603992422263,2193,2165,28,197.316493831225
"0072521006",0.0614826905847873,90,61,29,196.933244322708
"0072521007",0.763695489559881,2101,983,1118,170.014736690743
"0072521010",0.610437739472239,1355,758,597,177.196332178538
"0072521011",1.38175466493748,3002,1693,1309,167.272251648039
"0072521016",1.13980634338077,1956,1449,507,178.926715306642
"0073321011",0.977040362446491,3406,1283,2123,140.521680484029
"0073321016",0.321723300736436,1345,325,1020,171.332479684584
"0073321018",1.36635145010936,3238,1672,1566,163.629240085169
"0073321019",0.754704785928293,2606,968,1638,162.371415726002
"0073321022",1.11369527206978,2965,1418,1547,163.985849852446
"0075321006",0.733377641595466,3079,937,2142,136.168546244572
"0075321034",1.54282410503592,3136,1832,1304,167.312118107214
"0075321037",1.20204106991083,2419,1510,909,172.764356512925
"0075321046",1.33657760051058,1702,1645,57,193.976145502707
"0075321052",0.616672767149893,2318,767,1551,163.931469180245
"0075721013",0.285406723148054,2427,288,2139,136.526401872697
"0075721017",1.0164426669812,2995,1328,1667,161.724571712456
"0075721042",0.382886212229365,2550,410,2140,136.49535692042
"0075721095",1.81486103716616,3899,1974,1925,154.833772018944
"0075721102",0.0950829802919003,2135,83,2052,147.791980123846
"0076121004",1.44644556875855,1809,1746,63,193.586975022184
"0076121012",1.95632612887283,3820,2033,1787,158.898531541786
"0076121032",6.04636644244086e-13,36,31,5,213.235507759599
"0076121034",0.926362509241045,1418,1219,199,186.256519342002
"0076521011",2.6036425518977,3551,2153,1398,166.185292785097
"0076521036",1.50295132045705,1994,1799,195,186.416181663877
"0076521039",0.500435687592968,1576,600,976,171.970548051037
"0076521040",1.71938064727276,3314,1928,1386,166.289084636803
"0076521046",2.22122840795952,2838,2111,727,175.249537101782
"0077821030",0.347877808638226,1221,360,861,173.374356512925
"0077821032",0.934544849079704,3242,1228,2014,150.308136196806
"0077821048",0.212063837563515,352,203,149,188.333545086511
"0077821056",0.510322960132978,1165,621,544,178.17271240706
"0077821092",0.726457775280641,2373,925,1448,165.456738125845
"0078621049",0.171215542424735,1683,151,1532,164.216902354913
"0078621061",1.52631416606918,3343,1819,1524,164.289459748659
"0078621069",1.71318540525067,2595,1923,672,176.014582968106
"0078621071",0.904757953606721,2117,1192,925,172.591557688454
"0078621080",1.79676332112184,3669,1962,1707,160.840675539356
"0079221017",0.62574926233075,849,784,65,193.475622014704
"0079221069",1.49819856437884,3023,1795,1228,168.542896662949
"0079221077",1.15131505711737,1508,1460,48,194.38782853226
"0079221079",1.90327603310788,2922,2009,913,172.717088918477
"0079221082",0.338919774004349,961,350,611,176.866905772072
"0079921002",0.834185516251023,1816,1104,712,175.489601373429
"0079921015",0.958594452167014,2677,1256,1421,165.944965431929
"0079921017",0.977220355563737,1486,1284,202,186.132305177211
"0079921022",0.349354422685895,580,362,218,185.589727305007
"0079921024",1.15578976197723,3061,1465,1596,163.098488131949
"0082821003",0.990416028916701,2416,1302,1114,170.050545748582
"0082821005",0.349330338054016,1282,361,921,172.614399877013
"0082821009",1.94943894265145,2259,2028,231,184.996359722477
"0082821010",1.63915822326441,2828,1885,943,172.349638614987
"0082821014",1.08134721142072,2281,1386,895,172.932224765893
"0083321003",0.328691997302755,1188,333,855,173.424415107709
"0083321004",1.10151451698358,1803,1408,395,180.803109680084
"0083321009",1.7708631306544,2136,1948,188,186.583003626788
"0083321019",0.948845624068937,2656,1243,1413,165.9886420053
"0083321020",0.734122124373442,1227,940,287,183.576942481141
"0084441013",0.722136818418904,1062,916,146,188.466454704794
"0084441016",2.21543163830402,3968,2109,1859,156.9094604246
"0084441021",0.838092390272524,2189,1112,1077,170.640556969342
"0084441031",2.77896125543631,2715,2167,548,178.039377815988
"0084441039",1.22844404189246,3078,1539,1539,164.125404909936
"0084841001",1.08199639413908,2098,1388,710,175.511809360838
"0084841002",0.41126605315189,2156,458,1698,161.11355330684
"0084841017",0.3829244603338,1955,411,1544,164.02076745806
"0084841047",0.163875944978574,1520,140,1380,166.358233030457
"0084841059",1.2599631991321,3542,1575,1967,152.666637702012
"0087141021",0.209017102859494,953,198,755,174.747629662853
"0087141023",1.54465474219328,2731,1833,898,172.909082808361
"0087141025",0.262329145135562,615,261,354,181.603037374575
"0087141054",0.205579403929535,1636,193,1443,165.542844913057
"0087141059",0.392469948701164,1522,428,1094,170.338979912929
"0087341025",1.45937565894981,2458,1758,700,175.674267682334
"0087341031",0.841275002789664,1218,1114,104,190.882254977821
"0087341036",0.195077618437531,1050,180,870,173.242114222927
"0087341042",0.462484940659027,1558,532,1026,171.24828693578
"0087341043",0.757007686170565,1097,976,121,189.927661330441
"0090841023",3.26350536085335,2795,2188,607,176.969825077537
"0090841047",0.179753783171317,197,167,30,196.877305435012
"0090841048",1.47956279950747,2367,1776,591,177.278592924063
"0090841051",1.74797848429809,2068,1939,129,189.382545968188
"0090841052",0.645729821525235,2013,818,1195,168.980492125995
"0090941014",0.743140554714549,2277,952,1325,167.036088477007
"0090941030",1.19920958697273,2059,1507,552,177.943796357596
"0090941037",1.06750037174545,2474,1372,1102,170.253170744545
"0090941042",0.79858848374807,2681,1042,1639,162.358645531263
"0090941062",1.21327809953502,2319,1525,794,174.153735814163
"0096241014",0.0362244456016868,1735,49,1686,161.353580695319
"0096241015",0.422094375623378,1272,474,798,174.109008913406
"0096241016",0.561601420484246,2142,691,1451,165.393348928683
"0096241026",1.40271772495006,2597,1714,883,173.10928147213
"0096241031",0.85140695182988,2827,1126,1701,161.078019839726
"0098341084",0.000398689686318288,397,34,363,181.453014065749
"0098341087",4.03638545973653e-13,16,13,3,229.584444140613
"0099441012",0.0497504644592572,1034,57,977,171.966787363524
"0099441015",1.4501640925711,2168,1749,419,180.320923588705
"0099441017",1.86955889425338,2888,1997,891,172.984753795469
"0099441023",1.95431837474352,3101,2031,1070,170.686824304203
"0099441040",1.49471485667362,2263,1791,472,179.560306909536
"0102441004",0.449866618796012,1131,511,620,176.729365438777
"0102441010",0.676962855005926,1168,856,312,182.701631598015
"0102441012",0.395292849089979,1560,433,1127,169.930971855427
"0102441015",1.29452867488861,2087,1608,479,179.348573905258
"0102441017",0.274103351684534,985,269,716,175.412145901784
"0105341004",1.15873240726645,1593,1470,123,189.753211034944
"0105341009",1.28355636704811,2930,1598,1332,166.937963687528
"0105341011",0.655245705357315,1010,826,184,186.662346078533
"0105341017",1.29121548466012,1806,1602,204,186.032503607539
"0105341026",0.590070402785686,2099,737,1362,166.601189010336
"0105941003",0.760129154246095,2347,980,1367,166.567645640971
"0105941012",3.98159662173349e-13,114,12,102,190.917151237946
"0105941023",1.68070070845511,2326,1910,416,180.426900927677
"0105941040",0.25706485040011,2376,257,2119,141.160288897557
"0105941059",0.544845991432431,1434,666,768,174.560528115559
"0108941005",0.651330178237608,1122,825,297,183.272675332046
"0108941013",1.48152546653518,3072,1781,1291,167.464164010391
"0108941021",0.158122685125404,2295,136,2159,130.182535964983
"0108941042",0.501509362128534,1988,606,1382,166.354189891498
"0108941045",0.8027880623156,2014,1049,965,172.052939376362
"0115041006",2.33213710567526,3828,2124,1704,161.026047650062
"0115041010",1.99824622748281,2241,2048,193,186.440430484028
"0115041012",0.770872862613898,1191,999,192,186.440497514651
"0115041018",1.1145872583952,3129,1421,1708,160.835877917284
"0115041044",0.473340826780223,2651,550,2101,143.19182609444
"0115741002",0.220928483806236,302,217,85,191.972307488814
"0115741026",0.888399007518733,1841,1168,673,175.990131384372
"0115741038",1.07245866446765,2849,1377,1472,165.104502185448
"0115741041",0.932451779495363,3162,1226,1936,154.257896802072
"0115741058",0.465856114022858,2142,536,1606,162.830814565562
"0115841008",3.63108812271333e-13,2177,9,2168,127.862376256787
"0115841010",0.269410983865708,1867,268,1599,163.028138197628
"0115841024",1.37072722223507,1943,1680,263,184.003019839727
"0115841060",0.292750226505743,2331,296,2035,149.018431320387
"0115841065",0.979028612255978,1537,1287,250,184.267392932823
"0116041002",0.573858515471819,806,714,92,191.428738058842
"0116041021",1.71351793212641,3674,1924,1750,159.942596089793
"0116041025",1.42810385729291,1775,1736,39,195.485979115614
"0116041026",0.752959575610634,2828,966,1862,156.827223107325
"0116041028",0.959629713798677,3100,1260,1840,157.487880072139
"0119541001",0.448674859515688,1932,510,1422,165.936613206251
"0119541006",1.80799979596867,2076,1970,106,190.856038854616
"0119541012",2.55778949626291,4148,2149,1999,151.054041804886
"0119541017",0.656968089544582,1030,833,197,186.363705851836
"0119541018",0.774363890433342,2063,1004,1059,170.871733139744
"0121641053",0.215568749097244,985,209,776,174.394462313898
"0121641068",0.972921089735379,1601,1281,320,182.471108680003
"0121641078",1.17074986196606,1995,1481,514,178.814980701801
"0121641081",0.439789949905339,971,497,474,179.505145683571
"0121641087",0.429076720060164,1402,484,918,172.643861653278
"0125621001",0.796395195736092,1450,1038,412,180.485322458663
"0125621012",0.584947800134916,2583,728,1855,157.181208830559
"0125621020",0.891394915933955,2341,1172,1169,169.410949306544
"0125621025",0.180681808721771,517,169,348,181.830497111412
"0125621036",0.643309611200561,2979,813,2166,128.685020813051
"0127021001",0.128823858486695,1773,111,1662,161.808856953223
"0127021005",0.537460400001246,2317,658,1659,161.85037820712
"0127021019",2.67287375185684,2342,2160,182,186.68933073376
"0127021038",0.519064202812102,905,636,269,183.832477491376
"0127021045",0.812617366678234,2833,1072,1761,159.692538892855
"0129921001",0.687447212438957,1848,874,974,171.981437901354
"0129921006",0.954724005329867,1496,1250,246,184.406754385633
"0129921009",0.333560453977563,510,337,173,187.213596165665
"0129921025",0.341509132075287,505,354,151,188.23394657056
"0129921033",0.188344242164138,269,175,94,191.293674872556
"0130221019",1.8281862998646,3201,1981,1220,168.665528115557
"0130221020",0.274216000587863,1301,270,1031,171.172885041509
"0130221039",1.61848186344679,2371,1873,498,179.080556825643
"0130221046",1.10985496111532,2108,1413,695,175.717861515111
"0130221055",0.200775489258684,760,186,574,177.517461253393
"0132821008",0.013942082312285,1706,43,1663,161.802076044467
"0132821012",1.65366640093679,3605,1895,1710,160.797361448891
"0132821013",0.102601501619554,2255,93,2162,129.406381923365
"0132821014",0.00207906984699754,2198,37,2161,129.484614222923
"0132821018",0.27495210239309,2347,273,2074,146.387964257122
"0133721014",0.204707377668962,1247,191,1056,170.898404959416
"0133721015",0.86604871481129,1928,1144,784,174.284878999578
"0133721016",0.907706579274408,2952,1196,1756,159.839401459885
"0133721018",1.35443811627834,2131,1661,470,179.634158661986
"0133721019",1.88162637856249,2112,2001,111,190.574530288406
"0134421001",0.955366322048008,1439,1252,187,186.610654179928
"0134421003",1.3944169263537,3713,1703,2010,150.547845251508
"0134421004",0.260436433090374,1020,260,760,174.680594809641
"0134421029",0.135228784055322,363,115,248,184.288827165313
"0134421031",0.527008920657481,2378,646,1732,160.348152846508
"0134621004",0.95689915408813,3368,1254,2114,141.642782875192
"0134621008",0.99952934710899,2776,1307,1469,165.151396220133
"0134621023",0.855925185302606,2493,1136,1357,166.632839717704
"0134621037",1.99006784956332,2741,2043,698,175.704408075333
"0134621044",1.25971171540285,3151,1574,1577,163.43161715615
"0135821012",1.77759299938491,3367,1953,1414,165.986862238053
"0135821031",0.400678987981882,2097,439,1658,161.898262485045
"0135821039",0.137769323435668,1112,120,992,171.736560931998
"0135821049",0.529934796989072,1799,649,1150,169.621277835246
"0135821050",2.37026834157741,2868,2129,739,174.977464601689
"0138021006",1.89466543410703,2318,2004,314,182.626854880769
"0138021007",0.959066885429978,1277,1257,20,199.343799865151
"0138021008",1.22438800290394,3007,1534,1473,165.100381830703
"0138021039",0.521713645476182,794,639,155,187.919614268852
"0138021042",0.414701239057793,722,464,258,184.167137279666
"0138821008",1.08448719022215,2320,1390,930,172.55437954354
"0138821029",0.695833367103831,2734,884,1850,157.272975216333
"0138821038",0.19922917154807,1834,182,1652,162.145480941662
"0138821043",0.55253222190443,1785,677,1108,170.157796432457
"0138821049",1.3265850930668,2572,1635,937,172.485169372886
"0141321047",2.46018834284158,3403,2135,1268,167.924196629096
"0141321049",1.81832957186935,3665,1976,1689,161.332139123866
"0141321067",0.386452125338174,614,416,198,186.342979942146
"0141321073",0.61905351470479,1342,774,568,177.622106111778
"0141321080",0.980974076102696,2048,1290,758,174.708639928466
"0149721120",2.1627753239232,2879,2097,782,174.312430988572
"0149721122",1.08526519808504,2870,1391,1479,165.013543734422
"0149721127",0.130423165791534,1221,112,1109,170.143765741689
"0149721128",0.729564509443891,2952,928,2024,149.631384634454
"0149721144",0.214856359747162,362,208,154,187.92823687001
"0153321001",1.51677179357096,3122,1808,1314,167.208112639499
"0153321009",0.561749260892515,2740,692,2048,148.110227292631
"0153321014",0.0342525514174932,1175,47,1128,169.907290694433
"0153321034",1.24780388988111,3540,1557,1983,152.155276667975
"0153321036",0.76372315267976,2665,984,1681,161.439021740293
"0156421014",0.448089251859714,1378,507,871,173.239015251647
"0156421025",1.24892245945417,2060,1559,501,179.044328413285
"0156421026",0.556549865388525,851,683,168,187.467811885708
"0156421028",0.216054768759966,1504,211,1293,167.443510982883
"0156421047",1.175091484513,2931,1487,1444,165.499206808138
"0159821036",0.551915957366743,1836,675,1161,169.48498439852
"0159821039",0.234859964706137,2274,227,2047,148.112516536973
"0159821053",0.828710665869547,3263,1096,2167,128.455642377233
"0159821054",0.527810557922991,2147,648,1499,164.808618815596
"0159821059",2.10454986734875,3589,2078,1511,164.602601714573
"0160021002",0.464619127488004,540,533,7,210.654993437229
"0160021021",1.5722989152876,2393,1852,541,178.209587879383
"0160021027",1.25195230829963,3446,1563,1883,156.472422709136
"0160021034",1.92860365415737,3263,2018,1245,168.232733857109
"0160021047",0.355105038094113,413,371,42,195.057634046355
"0160521015",1.02349552933947,1850,1333,517,178.763499290348
"0160521025",0.706313430224279,2005,894,1111,170.116448493746
"0160521026",0.916065515663889,1944,1206,738,174.981518585697
"0160521041",2.02303878374073,3148,2055,1093,170.355742910022
"0160521042",1.70630201173025,3165,1919,1246,168.220826389222
"0160821001",1.53870574335133,3137,1826,1311,167.259450106947
"0160821007",0.104257871257764,722,95,627,176.631092100214
"0160821012",1.87833575860945,2551,2000,551,177.961554652227
"0160821015",0.410581852635813,817,455,362,181.477219087305
"0160821018",0.655836852950833,2869,828,2041,148.816535244365
"0161221013",1.47451069526925,2114,1773,341,181.976136292995
"0161221015",1.0603230605461,2742,1366,1376,166.399149224655
"0161221016",2.37324705678368,2568,2130,438,180.108036300411
"0161221021",0.304866570303945,313,309,4,218.962258789849
"0161221024",0.928315210816937,2034,1221,813,173.85359554414
"0161521001",1.21457208056785,2529,1526,1003,171.585652486075
"0161521002",0.226903870967459,1765,222,1543,164.033313240245
"0161521007",0.979511917005196,2803,1288,1515,164.475686975649
"0161521010",1.07864196978361,2618,1383,1235,168.383257190802
"0161521015",1.42697053717751,3764,1734,2030,149.310640871842
"0162721007",0.837840658476493,1477,1111,366,181.39449576576
"0162721010",1.42399263483284,2164,1732,432,180.174391400933
"0162721011",1.19275762389093,2734,1500,1234,168.385615411132
"0162721012",0.968854524391459,1933,1275,658,176.289324968747
"0162721022",0.346124227426072,367,359,8,209.51010505321
"0163221013",1.79034668612,3002,1959,1043,171.031074816412
"0163221014",0.515006649738739,2650,631,2019,149.870634019994
"0163221019",3.54154774596103,4191,2193,1998,151.072608998845
"0163221025",1.46915444208886,2629,1765,864,173.317388881665
"0163221032",1.01206424605383,3013,1322,1691,161.30054674033
"0165021002",0.832713675812027,2350,1100,1250,168.17299884386
"0165021011",1.27327845492947,3306,1586,1720,160.610617649256
"0165021015",1.57838133174884,3783,1855,1928,154.717507557476
"0165021021",0.966274081702681,3156,1272,1884,156.320355161285
"0165021032",0.903393816498137,2828,1187,1641,162.340195018033
"0166421007",1.1336411534942,3244,1446,1798,158.624131607059
"0166421029",0.778458159704666,1829,1013,816,173.828851582215
"0166421032",0.335162717995678,1832,342,1490,164.895470483532
"0166421035",0.778937148932097,2221,1015,1206,168.832604108676
"0166421045",1.35875936045662,2357,1667,690,175.78069265151
"0166621003",1.03210877189042,3259,1346,1913,155.173573662702
"0166621005",0.51762369271807,2213,634,1579,163.402973718304
"0166621018",0.250365940296884,1719,248,1471,165.104694087656
"0166621026",1.32123082881201,2685,1632,1053,170.927126144912
"0166621035",1.000560747572,2789,1309,1480,164.99868559607
"0166921025",1.08529221915131,2918,1392,1526,164.280587214254
"0166921031",0.459702233114647,1129,526,603,177.113744102302
"0166921035",0.156473230066394,579,133,446,180.029656394072
"0166921043",1.30997024455173,2377,1621,756,174.736870046642
"0166921052",0.770847718037814,1471,998,473,179.505606607483
"0167121006",1.32975111267211,1889,1637,252,184.231633801157
"0167121012",1.8507176831399,2023,1992,31,196.558634046355
"0167121015",0.71614509340777,970,910,60,193.721202520139
"0167121025",2.13892305293798,2572,2090,482,179.319747764184
"0167121055",1.91887451291605,2864,2014,850,173.478024140857
"0170241007",2.12300699862718,4207,2086,2121,140.551091683336
"0170241036",0.583416404304622,2742,724,2018,149.90592479327
"0170241054",1.25456441466854,3481,1569,1912,155.185166659443
"0170241055",0.530681482182583,2603,652,1951,153.474800979052
"0170241075",1.13237393445209,2202,1443,759,174.691635267073
"0170341002",0.479435612235678,2715,565,2150,133.683245401817
"0170341007",0.62014698246981,1069,776,293,183.345230623856
"0170341023",0.758178704677722,2290,978,1312,167.232888020258
"0170341028",1.84796363993825,2329,1989,340,181.981822050355
"0170341029",0.366014355920958,1325,385,940,172.407825777331
"0170541009",1.05884993736606,2328,1362,966,172.047073959546
"0170541035",1.22966180206006,2813,1542,1271,167.842271516316
"0170541066",0.780202472313896,2325,1017,1308,167.275687036656
"0170541084",0.239442566500771,646,239,407,180.577784215125
"0170541085",2.64010853735448,2385,2157,228,185.11431501268
"0171441005",0.916645715501665,1306,1208,98,191.023409908382
"0171441008",0.626613753901306,2010,785,1225,168.59356338454
"0171441009",1.78085666731651,2712,1955,757,174.71003008148
"0171441029",0.682675579574067,1819,864,955,172.135528506446
"0171441033",0.55228043906184,1031,676,355,181.601733142911
"0178421017",0.499853449895503,1530,598,932,172.537673802518
"0178421022",0.0734127301686367,1102,69,1033,171.150403018655
"0178421029",0.691259548998596,2478,877,1601,163.0238344368
"0178421046",0.399476556089266,973,437,536,178.318391123138
"0178521007",1.29982818238119,3680,1611,2069,146.933592780593
"0178521011",0.486881728311444,1232,577,655,176.347623013804
"0178521022",0.935984407767541,1635,1229,406,180.599805277451
"0178521044",0.803820446877749,1784,1056,728,175.214089976894
"0178521048",0.382472048546737,2122,408,1714,160.69597749138
"0178921003",1.66911690071722,3997,1903,2094,144.086646011989
"0178921004",0.197329392979514,1957,181,1776,159.269280889591
"0178921008",0.148259462828492,1284,129,1155,169.563492961914
"0178921048",0.287995098682628,2390,291,2099,143.376280889593
"0178921049",0.504811306989982,2602,615,1987,151.884901659628
"0179821009",1.0690639212538,1843,1374,469,179.640586659135
"0179821010",0.756012730741486,1449,973,476,179.472164781023
"0179821011",0.456216293370314,755,518,237,184.852800136886
"0179821020",1.46946065770539,2069,1767,302,183.068984265642
"0179821024",0.677023953553035,1609,857,752,174.773227529196
"0179921003",1.22793750813358,3504,1538,1966,152.876664789821
"0179921006",0.229883210242575,2104,225,1879,156.531359851517
"0179921007",1.22128742580738,3325,1532,1793,158.756626617811
"0179921011",0.498624280246739,1684,596,1088,170.451452148931
"0179921048",1.80797977407533,2380,1969,411,180.497851274668
"0180121007",1.54669524511965,3074,1835,1239,168.315587820342
"0180121016",1.30736539954472,3732,1616,2116,141.416780563109
"0180121022",1.53913393618794,3651,1827,1824,158.052033092194
"0180121026",1.8843360138994,4090,2002,2088,144.703670377511
"0180121030",0.797408481385872,3081,1039,2042,148.750591539218
"0180621011",1.19567221241608,2346,1502,844,173.526453861877
"0180621012",0.658160692992923,1438,834,604,177.102507650038
"0180621034",0.846444006000301,1866,1120,746,174.817060946049
"0180621041",0.342109144694662,1081,355,726,175.272690442692
"0180621056",0.802581808720908,2213,1048,1165,169.46002796274
"0180821001",0.863064357958813,3290,1143,2147,134.726180701802
"0180821019",0.1342091719404,279,114,165,187.626772291474
"0180821026",0.314994830248475,1642,320,1322,167.088182503287
"0180821027",0.405864624283457,2208,444,1764,159.667076055969
"0180821031",0.17525594841219,1198,160,1038,171.107408984606
"0180921038",1.27841551015745,2553,1591,962,172.058345084778
"0180921056",9.61262085604203e-14,2057,4,2053,147.712151237949
"0180921062",1.21944618032771,1652,1528,124,189.693364834001
"0180921065",7.8321652805766e-14,2082,3,2079,145.722151237951
"0180921076",1.2396798962086,3291,1552,1739,160.187856461013
"0181821001",0.587229945738206,1934,732,1202,168.901515836621
"0181821008",0.41025894650295,2088,454,1634,162.43260974689
"0181821014",0.406917628074387,2346,447,1899,155.642182318968
"0181821015",0.125380160339949,2125,109,2016,149.978269105711
"0181821018",1.88988316663673,3033,2003,1030,171.180963220203
"0182121004",1.15829425521591,1649,1469,180,186.851922019794
"0182121009",0.563582135843564,1634,696,938,172.443689125244
"0182121018",1.10982145684849,3081,1412,1669,161.695384285066
"0182121033",0.416756216305976,2213,467,1746,160.106137894591
"0182121036",0.694405248567566,2228,881,1347,166.755562915727
"0182321003",2.77334860507993,3607,2166,1441,165.582593978514
"0182321012",2.6577409796729,2736,2159,577,177.491050568122
"0182321029",0.833158184467643,2652,1102,1550,163.949943691599
"0182321043",1.9378130761334,3598,2023,1575,163.461007857954
"0182321050",0.5996474766787,1999,746,1253,168.100618969066
"0182621001",0.100704224582873,2163,90,2073,146.405459150416
"0182621004",0.357053973779774,2341,373,1968,152.658881804949
"0182621014",0.367408010439192,2139,388,1751,159.932634965941
"0182621031",0.274945480292817,2396,272,2124,140.328182503288
"0182921003",1.57393579310784,1931,1853,78,192.363382809622
"0182921035",1.05507998766249,1634,1360,274,183.725346493322
"0182921044",1.84814979375753,3092,1991,1101,170.253637520913
"0182921047",0.303026935512031,857,308,549,178.017839717704
"0182921081",0.879835248760389,1492,1154,338,182.018218712401
"0183521003",0.704837070516528,1836,891,945,172.337728693653
"0183521008",0.468217208001108,920,541,379,181.163445129533
"0183521015",1.04862729275455,1439,1355,84,192.048713840058
"0183521023",1.07984398397473,2117,1384,733,175.074036229277
"0183521029",2.06802417347828,2529,2072,457,179.883975916914
"0183821002",1.15743446590748,3305,1468,1837,157.591876510326
"0183821018",0.364936649648567,1208,382,826,173.752995109449
"0183821034",0.456562908157592,624,519,105,190.876652329451
"0183821041",1.7607899247478,2730,1945,785,174.269947820398
"0183821044",0.810072414423026,2908,1067,1841,157.457629557965
"0184721012",0.329542474819133,2406,334,2072,146.556578020466
"0184721014",1.01469601698073,2980,1326,1654,162.058523980158
"0184721026",1.06237848100018,2745,1368,1377,166.385556620477
"0184721048",0.849955981866654,3250,1123,2127,139.340392423657
"0185521006",1.17178966599776,2972,1483,1489,164.928527411994
"0185521011",1.69290854417528,2646,1916,730,175.116717346439
"0185521013",1.20237571436001,2367,1514,853,173.458368868298
"0185521019",1.94800477214167,2435,2026,409,180.503242886246
"0185521023",1.02462391677267,2114,1336,778,174.334145846259
"0185621010",0.412402676113749,641,462,179,186.853032513631
"0185621014",1.13261182055464,2002,1444,558,177.797613711391
"0185621033",0.617034416922482,1356,769,587,177.335718539276
"0185621045",1.51027391820915,3579,1806,1773,159.433073557728
"0185621047",0.295881216202402,493,299,194,186.42389045291
"0185821005",0.800406360445568,2285,1044,1241,168.287154865172
"0185821015",0.598589042715604,2474,743,1731,160.362272213235
"0185821017",1.68904145629443,3830,1914,1916,155.099501675497
"0185821039",0.987140588117896,2592,1300,1292,167.449310221298
"0185821051",1.13320235071212,1471,1445,26,197.612087110742
"0187521022",1.3671553641884,1728,1673,55,194.028864507962
"0187521033",0.787273786607435,1428,1028,400,180.690020149733
"0187521037",2.84270480437801,2698,2175,523,178.5925688786
"0187521041",0.681652490753993,2157,862,1295,167.424669700055
"0187521049",2.46244361849338,2463,2136,327,182.318432817076
"0188121003",0.724210023257601,1673,922,751,174.774155389
"0188121004",0.363681656387751,1259,381,878,173.14844617721
"0188121030",4.83153291154849e-13,2163,19,2144,135.043521300016
"0188121043",0.586573286561996,1805,731,1074,170.667107092023
"0188321016",0.135485208283176,1434,116,1318,167.1558649104
"0188321035",1.4105000237014,3656,1721,1935,154.258397628015
"0188321051",1.95984450688401,2955,2036,919,172.625640178161
"0188321052",1.62067755070659,2964,1874,1090,170.408187092337
"0188321053",0.405335621460892,1528,443,1085,170.4831298347
"0188621011",0.445990879188224,1274,502,772,174.479428623151
"0188621012",0.301250584349284,467,307,160,187.798743369749
"0188621034",1.36593517015413,1904,1671,233,184.962006914494
"0188621050",0.29455323356787,778,298,480,179.34762827278
"0188621065",0.683275207850963,1453,865,588,177.321863683513
"0188821005",4.19758276959292e-13,1704,16,1688,161.343184442037
"0188821007",2.54108332492615,3049,2147,902,172.858918287845
"0188821027",0.311655477216385,1671,316,1355,166.640008069043
"0188821035",1.63317007162422,2146,1881,265,183.934460474767
"0188821036",2.56237535659997,3471,2150,1321,167.107795279825
"0189121007",0.884681143969691,2517,1163,1354,166.642250114732
"0189121032",1.41338094389642,2863,1722,1141,169.709401131546
"0189121055",1.32049994815775,2698,1631,1067,170.723149307468
"0189121056",3.21888500082267,3386,2186,1200,168.9163688786
"0189121060",0.298467001131932,1382,302,1080,170.622743090368
"0190121008",0.413175559228661,1446,463,983,171.84578476476
"0190121020",2.04965399576287,3934,2065,1869,156.72248860822
"0190121026",1.80445554209037,3857,1967,1890,155.9936462296
"0190121033",0.477451741557826,627,560,67,193.424038169259
"0190121053",0.806468887270585,1405,1060,345,181.868513268173
"0190221001",1.11776541041215,3535,1431,2104,142.663301211657
"0190221005",0.648903022187009,1285,823,462,179.791361870011
"0190221012",0.775266936570997,1991,1005,986,171.808862961746
"0190221016",1.48847166600649,3021,1785,1236,168.364026065432
"0190221026",0.592777400708592,2336,739,1597,163.093241968643
"0190321003",1.43602069027013,3361,1742,1619,162.606336694894
"0190321010",0.733685473137737,1710,939,771,174.506345449724
"0190321014",0.482279360908478,1061,570,491,179.199670377509
"0190321061",0.769343297562333,2811,996,1815,158.259434725245
"0191721004",2.30900887569456,3067,2119,948,172.255452302399
"0191721028",0.872804075380236,2536,1149,1387,166.264802141524
"0191721030",0.788554990856715,1574,1031,543,178.173281226927
"0191721039",1.60051543590529,2648,1867,781,174.318123736052
"0191721052",1.1159242601798,2575,1426,1149,169.621959972647
"0192021016",1.12230551886245,2907,1433,1474,165.099546653558
"0192021017",0.476663866799189,1306,558,748,174.789923854989
"0192021027",0.699767873386177,1923,886,1037,171.122872904243
"0192021042",2.53048882289826,2740,2146,594,177.259177741686
"0192021063",0.170871937659279,1061,150,911,172.730729927948
"0192421005",0.0659056807325712,728,64,664,176.141329531797
"0192421007",0.494762643650764,689,590,99,190.98635830736
"0192421009",0.926804688092465,1233,1220,13,201.07934357666
"0192421021",0.765441410069681,1000,991,9,206.041486475494
"0192421033",2.35008736297363,2194,2126,68,193.407274958337
"0192621007",0.388338885676192,1439,422,1017,171.370803085405
"0192621016",0.42536588251357,1497,479,1018,171.369789314292
"0192621019",5.06182827535399e-13,890,21,869,173.255507759594
"0192621038",0.188292590795344,1743,174,1569,163.57181576325
"0192621066",0.236383514855581,1537,231,1306,167.295776001528
"0192721007",1.48132887359752,2969,1780,1189,169.116165744181
"0192721019",1.35957558024766,1902,1668,234,184.959244479618
"0192721024",1.07533184288054,1693,1380,313,182.680153630693
"0192721027",1.37022737297644,2373,1679,694,175.740537880758
"0192721044",2.00294001369388,4152,2050,2102,142.839979345325
"0194521002",0.555445421986028,737,681,56,193.992204540632
"0194521004",0.051292950272454,1458,58,1400,166.180586717354
"0194521005",1.59678149923671,3253,1864,1389,166.254606562942
"0194521050",1.6701894298635,2778,1904,874,173.194943838164
"0194521058",1.54787924046825,3290,1838,1452,165.366769607858
"0194721003",2.13723189514953,3815,2089,1726,160.494120618887
"0194721007",2.03284225278804,3658,2060,1598,163.08517923714
"0194721026",0.201829376331238,1366,188,1178,169.287408566599
"0194721032",1.33034203942929,3366,1638,1728,160.451462040515
"0194721049",1.24998349344699,3564,1562,2002,150.902702386346
"0196221002",0.704314758473367,1489,890,599,177.175738969256
"0196221015",1.7413773857573,2755,1936,819,173.811356622812
"0196221039",0.777636230106577,1389,1011,378,181.191778945621
"0196221056",1.27943882870014,2939,1594,1345,166.769218831185
"0196221058",0.802850573782518,2590,1050,1540,164.100610271115
"0196921003",0.387920355214128,2592,421,2171,126.965834179619
"0196921005",0.447907415437139,2679,506,2173,126.324842457695
"0196921006",0.806613249129889,2890,1061,1829,158.000947044722
"0196921024",2.32466262757793,4019,2123,1896,155.843581166899
"0196921031",1.09301891144823,1849,1397,452,179.906707105116
"0197021015",2.55692928955553,4232,2148,2084,145.417253400261
"0197021020",2.10356849936234,3225,2077,1148,169.63164583732
"0197021025",1.14811316434549,3253,1454,1799,158.581443329663
"0197021034",0.336052166915443,1031,343,688,175.824193024204
"0197021042",1.93442742156392,4012,2021,1991,151.609960085784
"0197821002",1.34777080992684,1764,1657,107,190.814258309828
"0197821011",0.964337354347156,2560,1266,1294,167.434247367177
"0197821024",1.05360204661058,2963,1358,1605,162.840487957767
"0197821032",1.02321905187528,1918,1332,586,177.349756268358
"0197821033",0.17634911445395,1784,162,1622,162.581940783161
"0198221016",0.816897067642717,2316,1079,1237,168.340105949949
"0198221017",1.64904387879231,2533,1892,641,176.426652626668
"0198221018",1.18469379371405,1528,1494,34,196.117481534547
"0198221030",1.33375955251996,3355,1643,1712,160.732538101578
"0198221046",1.7151448067179,2921,1925,996,171.671405216989
"0198321005",1.93306027183931,3327,2020,1307,167.288281700106
"0198321007",0.186865898381069,473,173,300,183.09874025941
"0198321076",0.395224341963137,472,432,40,195.255792417548
"0198321086",0.766916161615808,1250,993,257,184.168758020651
"0198321096",3.26976019430136,3208,2189,1019,171.366756935649
"0198521015",2.05223117228591,2275,2068,207,186.01049546847
"0198521028",0.922512190173728,1565,1215,350,181.728649911984
"0198521036",0.485512076212006,2634,576,2058,147.512724811417
"0198521039",0.889102456448855,2660,1169,1491,164.891316852941
"0198521046",0.282590672286165,909,284,625,176.635181871717
"0199321023",0.194711116805651,2276,179,2097,143.925295790155
"0199321024",1.09816625242066,2207,1405,802,174.065400816249
"0199321031",0.607623079679232,1288,755,533,178.384954433024
"0199321036",1.11599606127861,3331,1427,1904,155.549417401479
"0199321040",0.754626545738709,1701,967,734,175.062048244872
"0200021017",0.358711816424581,2492,377,2115,141.487552645464
"0200021039",1.72615015351336,4119,1931,2188,97.4566228419701
"0200021066",5.77109336069251e-13,2086,29,2057,147.515507759596
"0200021078",3.54834037250234e-13,2171,7,2164,129.191583990906
"0200421017",0.207337029078386,1133,194,939,172.440685787381
"0200421045",0.243240264934956,2353,244,2109,142.297335306592
"0200421052",0.159018850295266,2255,137,2118,141.219736964023
"0200421057",5.95371933919475e-14,2108,1,2107,142.432151237952
"0200621016",0.63208857697556,1493,791,702,175.627809697842
"0200621028",0.601030838642086,1419,749,670,176.060991256426
"0200621038",0.0901138353882211,1892,76,1816,158.243137492561
"0200621039",0.972894181248415,2910,1280,1630,162.47014906747
"0200621041",0.531585918818824,2358,655,1703,161.029363330768
"0201421001",1.00204429985336,3269,1313,1956,153.221455778024
"0201421021",1.52250392904157,2148,1815,333,182.175516021785
"0201421033",0.287923100428249,1766,290,1476,165.052692835223
"0201421035",1.20053666913064,3224,1508,1716,160.65468183141
"0201421054",0.779719748719893,2960,1016,1944,154.01805722767
"0202321006",0.44170319167137,1895,500,1395,166.225064813518
"0202321010",0.614698659516761,775,761,14,200.79283626898
"0202321014",1.62827802235385,3130,1879,1251,168.128355967082
"0202321019",1.16497075132878,2267,1476,791,174.188725665503
"0202321023",0.308516294052811,2203,314,1889,155.997049674208
"0203021022",1.5120111289903,2454,1807,647,176.375024060625
"0203021028",0.524285692976642,2066,643,1423,165.902424200611
"0203021033",1.19582774119349,1966,1503,463,179.784866477757
"0203021036",1.48364270245518,2337,1784,553,177.937528212109
"0203021046",1.22610350218182,2745,1535,1210,168.775367474584
"0203221027",1.95619063059396,2757,2032,725,175.280759181707
"0203221030",0.744825890794268,2142,955,1187,169.117508986645
"0203221046",0.551079563573847,1998,674,1324,167.064274436617
"0203221057",2.05019637467825,2579,2066,513,178.820125691399
"0203221060",0.909221454844353,1340,1201,139,188.919258514418
"0205021005",0.978379075794895,3171,1286,1885,156.303255928646
"0205021046",1.02895633276109,2810,1342,1468,165.199383026478
"0205021051",0.496891700456655,2333,595,1738,160.214718790291
"0205021054",0.623203936353691,2757,781,1976,152.410703666711
"0205021060",1.30992094375393,2937,1620,1317,167.183401188284
"0205821003",1.11522746189323,2656,1423,1233,168.394162059494
"0205821007",0.238628542416811,1512,237,1275,167.720668639927
"0205821014",1.43331579017084,3444,1739,1705,161.008382608794
"0205821015",1.33221650682033,2146,1640,506,178.949088908808
"0205821016",0.479199597151957,1847,563,1284,167.619896745211
"0206921011",0.00702729062978655,684,40,644,176.41798212795
"0206921014",1.54733476963463,3030,1836,1194,168.98948781567
"0206921018",0.0376932356459198,1428,50,1378,166.381018710995
"0206921026",1.59385719834099,3520,1863,1657,161.960588179937
"0206921042",0.640390697434453,2750,804,1946,153.93932538394
"0207921001",2.29942185255542,3727,2117,1610,162.793547417699
"0207921011",0.438556413282292,1475,496,979,171.939438326083
"0207921024",0.880042881661367,1538,1155,383,180.998351363935
"0207921027",0.558684669547009,856,686,170,187.308172492713
"0207921031",2.32011384175258,3513,2121,1392,166.241501199663
"0208421013",0.24097692899858,1914,240,1674,161.6512611339
"0208421026",0.180145648023128,2006,168,1838,157.550826367806
"0208421027",0.776327058654997,1352,1008,344,181.895746890009
"0208421036",1.59749032113788,2000,1865,135,189.22331486788
"0208421040",1.09566019029806,1657,1401,256,184.173072090732
"0208921002",0.944531692754736,2264,1237,1027,171.23434509366
"0208921003",0.22305799576165,1961,219,1742,160.12150881893
"0208921006",0.466871661078647,2086,540,1546,164.007341985397
"0208921012",0.170350092435569,2042,148,1894,155.909439020009
"0208921016",0.274768629767742,1156,271,885,173.084715432274
"0210021003",1.7517159469976,2147,1942,205,186.031701965736
"0210021005",1.49740516298592,3070,1794,1276,167.718030200208
"0210021007",1.50931808803016,3347,1805,1542,164.07490309047
"0210021010",1.85768542259473,3727,1994,1733,160.346121509802
"0210021019",1.71882690972224,3489,1927,1562,163.676618524731
"0210821026",1.0265785264633,2728,1338,1390,166.251500567451
"0210821028",1.7520797539607,2771,1943,828,173.738693006964
"0210821037",1.19705530837267,1953,1505,448,179.989607092022
"0210821043",1.22108174414512,2271,1531,740,174.922308671968
"0210821050",0.648485415640814,1497,822,675,175.97976779831
"0212621008",1.43032138088578,2268,1737,531,178.409994970584
"0212621011",0.530952701965491,1821,653,1168,169.447433687181
"0212621019",0.140355096954685,1664,123,1541,164.07985521825
"0212621021",1.1593647237345,1507,1471,36,196.007243494386
"0212621030",0.474314897718074,801,552,249,184.286118009958
"0213121008",0.615846235340991,1178,765,413,180.484652814033
"0213121010",1.63933558918373,3450,1886,1564,163.634419807815
"0213121015",2.48314696253656,3018,2141,877,173.186520730564
"0213121016",0.500679981119427,1464,601,863,173.327000057961
"0213121022",1.26694746996446,2111,1581,530,178.439047758432
"0215721006",0.972432263488644,1573,1279,294,183.313679826654
"0215721014",1.2534015316866,2671,1565,1106,170.197846493323
"0215721041",1.92217794151537,2833,2015,818,173.82123274421
"0215721053",0.855589315206379,1612,1135,477,179.470961273921
"0215721082",1.05300134411825,1430,1356,74,192.423286332746
"0216321073",0.727044977006237,1393,926,467,179.669110833008
"0216321076",0.860330310301367,2731,1138,1593,163.14422827423
"0216321078",0.204082380655938,655,190,465,179.715048647228
"0216321085",0.205446446810076,1620,192,1428,165.835568856998
"0216321089",1.47946303295148,3421,1775,1646,162.262253325802
"0216921025",1.25928142904687,2790,1573,1217,168.699427357227
"0216921070",0.108759992199095,762,101,661,176.207765900345
"0216921078",0.567622559608104,1550,703,847,173.511162397994
"0216921082",0.345980301276727,1577,358,1219,168.688852594191
"0216921085",1.06779293548181,3323,1373,1950,153.537591022673
"0218021009",2.30328899075355,2935,2118,817,173.825110937379
"0218021010",0.717004605394186,2874,911,1963,152.915631278837
"0218221012",0.33042274306253,1622,335,1287,167.564261379929
"0218221013",0.502040775120322,932,609,323,182.399759314476
"0218221016",1.25384752049412,3166,1566,1600,163.027417370372
"0218221019",0.786804569975023,1436,1026,410,180.501643219776
"0218221031",1.90078966650508,2890,2006,884,173.101012568079
"0218321002",0.74039230618569,1465,949,516,178.79004349867
"0218321003",0.738047327498743,2058,945,1113,170.095715890353
"0218321006",0.390330416050976,1983,425,1558,163.783781814706
"0218321016",0.385043768414118,659,414,245,184.544116641784
"0218321019",0.72986601167796,1755,930,825,173.764414941743
"0218721014",0.631977355859687,2470,790,1680,161.485569455716
"0218721018",0.278655140085756,2231,277,1954,153.309697010089
"0218721021",1.37694029941564,3661,1687,1974,152.446761670026
"0218721022",0.422497054657248,2112,475,1637,162.401066291678
"0218721055",0.764200865091075,2935,987,1948,153.706177123625
"0218921008",2.46505093952717,3534,2137,1397,166.185841708989
"0218921016",1.07185995479787,1901,1376,525,178.524924418106
"0218921022",2.18039520271034,3673,2102,1571,163.560766590503
"0218921037",1.09269868726957,2584,1396,1188,169.117005290678
"0218921038",0.889680057788088,1376,1170,206,186.017843583089
"0219421027",1.22694053937429,1913,1536,377,181.197083893689
"0219421037",0.61574942362524,2383,762,1621,162.592890206734
"0219421044",0.777261227590069,2142,1010,1132,169.769894116983
"0219421057",0.952418076105006,1944,1247,697,175.704755481245
"0219421065",1.70083567736351,3474,1918,1556,163.789756571148
"0220621020",0.53038463359486,1393,651,742,174.881788269909
"0220621024",1.78166242818364,3156,1957,1199,168.933373538065
"0220621025",0.382765970887598,993,409,584,177.363306800172
"0220621026",0.712141316168659,2733,903,1830,157.997861026401
"0220621029",1.55164272485771,3321,1839,1482,164.965068155927
"0221321001",0.171868849946921,1025,152,873,173.201297843473
"0221321004",1.35868187646337,1689,1666,23,198.146740903247
"0221321022",0.479303587664161,1861,564,1297,167.403446039971
"0221321034",2.01106980909332,3027,2052,975,171.970704054663
"0221321037",1.41902822260639,1852,1727,125,189.528282689482
"0223021009",1.81391182811284,3426,1972,1454,165.350292469063
"0223021027",0.867499222079918,1264,1145,119,190.098738507338
"0223021031",0.337379120244359,866,346,520,178.650493831224
"0223021051",0.305698903385564,790,312,478,179.446696681708
"0223021054",0.602845472598091,1551,751,800,174.083531447003
"0223321002",0.30491262193127,472,310,162,187.777559224781
"0223321031",0.900466802555266,2215,1183,1032,171.172353004803
"0223321049",1.42411593971461,2783,1733,1050,170.9552285405
"0223321051",1.60149160196786,2038,1869,169,187.401981819674
"0223321052",0.884718861201101,1725,1164,561,177.74832552421
"0223521015",0.641770421572464,2583,809,1774,159.347924593146
"0223521019",0.326924279951807,1321,332,989,171.767522882192
"0223521023",1.03202975633727,1998,1345,653,176.352128630815
"0223521040",1.50171259740028,2613,1798,815,173.843699467418
"0223521041",1.91321085656677,2480,2012,468,179.649825215646
"0224121001",0.513058693660195,1676,630,1046,171.016042053441
"0224121002",0.984348899657452,2725,1295,1430,165.779436717896
"0224121003",1.29414906226398,2293,1607,686,175.847676504076
"0224121017",0.764605531262133,2569,988,1581,163.324679382033
"0224121019",0.472558183257259,2510,548,1962,152.919137543731
"0225321003",0.580121544215981,2455,720,1735,160.292455988743
"0225321006",0.981652655073745,1422,1291,131,189.359512438289
"0225321007",0.860867388727862,1273,1140,133,189.352216230045
"0225321009",1.34025631662245,3302,1652,1650,162.193810124824
"0225321049",1.34333557930756,3372,1654,1718,160.644353218429
"0225721003",2.12357851005854,3356,2087,1269,167.921681059218
"0225721008",1.29184271687583,2767,1603,1164,169.471796305157
"0225721010",1.24969195426517,2733,1560,1173,169.384741395948
"0225721017",1.45727228988332,3482,1755,1727,160.480167000358
"0225721019",0.754857554726404,1265,970,295,183.303008245279
"0225921005",0.855091531134503,1743,1133,610,176.953378552742
"0225921026",2.03764494852853,2093,2061,32,196.154073996857
"0225921028",1.63245198307368,2940,1880,1060,170.869276498073
"0225921031",0.905980726670744,1697,1193,504,178.966789950385
"0225921032",0.174711826458411,790,157,633,176.589566631016
"0227221004",1.24641480044862,2479,1556,923,172.607208717372
"0227221015",0.308668481260113,556,315,241,184.746354314179
"0227221041",0.557485827353665,1467,684,783,174.297789927874
"0227221046",0.174800789303611,1537,158,1379,166.362378805873
"0227221050",2.18713983551463,3278,2103,1175,169.375483300856
"0227821001",2.03992164044138,3311,2063,1248,168.215761771113
"0227821029",0.83362626521943,1733,1103,630,176.618893397691
"0227821035",0.300683239225494,1534,305,1229,168.534611590709
"0227821055",1.18819311760074,2761,1497,1264,167.978892801011
"0227821061",0.846147951073259,1724,1119,605,177.01102627985
"0229121003",1.81425159315831,3752,1973,1779,159.223947531314
"0229121027",1.45460916452901,2647,1754,893,172.97166447406
"0229121034",1.66072080307546,3007,1900,1107,170.188756376858
"0229121046",1.56866482314664,2315,1849,466,179.699406891061
"0229121049",1.49499651022977,2226,1792,434,180.156550037596
"0229821006",1.6387231298963,3817,1884,1933,154.391886694696
"0229821019",0.333981725361211,425,338,87,191.924749789755
"0229821027",1.02158649497893,3251,1331,1920,154.937009334899
"0229821035",2.2656534752599,2921,2113,808,173.973406652991
"0229821049",2.05314788880038,3969,2069,1900,155.628756775536
"0233221001",0.78258446839733,2135,1020,1115,170.024741059623
"0233221002",0.48458357417879,2765,574,2191,86.2798601365669
"0233221012",0.213941602925037,2299,206,2093,144.168895698433
"0233221018",0.643113365523114,2955,812,2143,135.419869810636
"0233221019",2.15533242250047,3054,2095,959,172.111551261606
"0233321008",0.435850973796335,2249,494,1755,159.84310182582
"0233321009",0.814850470557611,1480,1077,403,180.655565104279
"0233321021",2.05600881323836,2485,2070,415,180.466873662547
"0233321023",1.93547863532948,3579,2022,1557,163.7875788141
"0233321026",2.11637492959364,3300,2082,1218,168.698973857457
"0233421001",1.53458537342174,3520,1824,1696,161.192803047438
"0233421006",0.813237156265569,2705,1074,1631,162.465753082099
"0233421014",1.67656453802576,2392,1908,484,179.269653969894
"0233421027",0.695627239442956,1739,883,856,173.398460085785
"0233421032",0.560317337166163,1243,688,555,177.860913877712
"0234421006",0.803033909522216,2170,1051,1119,169.998118589391
"0234421008",1.52098865779739,3965,1812,2153,132.832201567545
"0234421061",0.977798050808029,2401,1285,1116,170.021644653898
"0234421069",0.177397655158335,2029,165,1864,156.815845066006
"0234421087",0.6326919616443,2654,794,1860,156.878089827204
"0235121003",0.253387486567352,1283,254,1029,171.2199352052
"0235121004",0.00266624705957592,114,38,76,192.375514065755
"0235121005",0.420828484886027,831,471,360,181.516823924164
"0235121008",0.953925106497322,1468,1248,220,185.287939413725
"0235121010",0.6503707635973,1419,824,595,177.252009278902
"0235421002",0.284512703873176,2161,285,1876,156.654414652407
"0235421006",1.13790497398923,3572,1447,2125,139.673194139228
"0235421007",2.44907151506608,2268,2134,134,189.323222901437
"0235421009",0.313042828256533,2188,318,1870,156.698413094566
"0235421018",1.64232753449315,3151,1889,1262,167.98747649002
"0235521003",1.24625642580019,3433,1555,1878,156.563186620961
"0235521005",0.0947447172563288,1075,82,993,171.707035422505
"0235521027",1.14394640068077,3516,1451,2065,147.115118402494
"0235521036",1.84809838280241,3549,1990,1559,163.779121509987
"0235521047",0.895302895679473,2982,1177,1805,158.506011958706
"0238121004",0.918170273595683,1458,1211,247,184.339156189531
"0238121006",1.44997998536669,2938,1748,1190,169.106262675938
"0238121028",0.252179037651551,366,252,114,190.422994228913
"0238121029",2.08183866732683e-13,2161,6,2155,131.422151237946
"0238121033",0.8354811266812,1617,1109,508,178.883741605861
"0238921007",0.884077661446042,1579,1162,417,180.421257805184
"0238921010",1.58681916561074,1979,1859,120,190.014601426007
"0238921016",1.12863097252589,3030,1436,1594,163.122301354446
"0238921019",0.420329900681056,1106,469,637,176.482956629031
"0238921047",1.11206571052606,3407,1415,1992,151.576135774384
"0239121028",1.45845764252561,3811,1757,2054,147.654371625217
"0239121043",0.850949543612406,1500,1125,375,181.20421748769
"0239121049",1.00125931700264,2190,1311,879,173.138632728035
"0239121059",0.615849247163674,1211,766,445,180.055304323179
"0239121060",0.238819105869907,1359,238,1121,169.975892230366
"0240121003",1.00166618349989,1975,1312,663,176.196008375656
"0240121048",1.10784719306968,2250,1411,839,173.578171203678
"0240121056",1.28475365567385,2552,1599,953,172.157154569826
"0240121071",1.62724109152054,2263,1878,385,180.993135772376
"0240321004",0.933495333760676,1469,1227,242,184.71104117004
"0240321013",0.966844900105513,2992,1273,1719,160.62378373371
"0240321016",0.582877751728024,996,723,273,183.726164181318
"0240321021",0.772372712358406,1683,1001,682,175.893462769854
"0240321025",1.8551873556646,4049,1993,2056,147.584385041508
"0240421017",0.461994628964682,957,530,427,180.250582041912
"0240421019",3.15193218718154,3639,2184,1455,165.349892268878
"0240421027",1.52791357178507,2570,1823,747,174.815837385917
"0240421033",1.16776826285616,2136,1480,656,176.316067474641
"0240421034",0.16855476642483,866,144,722,175.323718243679
"0240821005",0.0985612972752947,233,85,148,188.414098843303
"0240821007",1.03013234133005,2774,1343,1431,165.752535844645
"0240821009",0.473838476207481,1433,551,882,173.116487160388
"0240821012",0.575780006881383,1247,715,532,178.403599433057
"0240821020",0.405980107096898,887,445,442,180.099717097675
"0242121002",0.621643615564659,2474,779,1695,161.249282321409
"0242121006",1.16746936411271,1880,1479,401,180.687067503089
"0242121015",0.583885529126694,2536,726,1810,158.386290516465
"0242121016",1.18297058923222,1811,1490,321,182.463393523832
"0242121023",0.791706372532859,2521,1033,1488,164.933242273147
"0242521017",1.06591619592481,2895,1370,1525,164.283143225429
"0242521021",1.34620142888428,1792,1656,136,189.167142558113
"0242521024",1.08012136989391,2410,1385,1025,171.266423944366
"0242521032",2.18722734004075,3874,2104,1770,159.46331963526
"0242521043",0.588367023953076,1303,734,569,177.569070208661
"0242621001",1.03595256608809,1576,1349,227,185.115048042638
"0242621005",0.502885482493859,2438,612,1826,158.028329331268
"0242621008",0.520305759967628,838,637,201,186.225875593312
"0242621012",0.394170027506216,1412,430,982,171.861578026624
"0242621014",0.64651067407748,1357,820,537,178.307089247416
"0242721003",1.37191514693375,3236,1681,1555,163.789924168327
"0242721025",1.26259182120528,3319,1578,1741,160.15654824274
"0242721028",0.694860027460227,2932,882,2050,148.036018386054
"0242721040",0.426013694903865,2541,480,2061,147.341932987972
"0242821008",0.169388543364053,1857,146,1711,160.749199566695
"0242821011",1.83500200657538,3980,1985,1995,151.2509689491
"0242821017",0.123396804753898,1371,108,1263,167.983236265582
"0242821020",0.104584903046809,340,96,244,184.673013051662
"0242821025",2.16318695985728,3245,2098,1147,169.651208255269
"0243421004",1.15240829223895,3372,1461,1911,155.249423282803
"0243421008",1.87043841723759,3770,1998,1772,159.439269328046
"0243421020",1.50417822927098,2727,1800,927,172.587197753981
"0243421022",1.77721299361447,3700,1951,1749,159.996646011989
"0243421024",0.100190693615669,1880,89,1791,158.827116692838
"0243521002",1.74463729077358,3418,1937,1481,164.989608316031
"0243521004",0.561255124431218,1409,690,719,175.366454758304
"0243521007",0.548794657777269,2845,671,2174,125.572137091524
"0243521010",0.632394868523842,2609,792,1817,158.242269324965
"0243521012",0.772684774354534,2408,1002,1406,166.09784153922
"0244521005",1.58942505411573,2867,1860,1007,171.5139509725
"0244521019",1.94906637695895,2733,2027,706,175.567818882788
"0244521025",1.39178253098922,2161,1702,459,179.857737147997
"0244521047",0.218891383777925,368,215,153,188.034852307992
"0244521050",0.288908821817087,376,293,83,192.080291693919
"0245121016",1.10219855524484,2778,1409,1369,166.549562072937
"0245121031",0.737216272643855,2974,943,2031,149.210358589603
"0245121034",0.379228063918076,624,402,222,185.215482829687
"0245121036",0.766404862841053,2115,992,1123,169.966117363356
"0245121047",0.453493596719447,959,515,444,180.060488763748
"0245321049",7.08830905878885e-13,2213,32,2181,117.665507759603
"0245421001",0.571890407589533,1762,710,1052,170.934362178989
"0245421003",0.476176770675348,718,557,161,187.795872115232
"0245421010",0.88827427593029,1211,1167,44,194.722419740951
"0245421014",0.72848300116482,2093,927,1166,169.456687525968
"0245421020",0.944032991200008,1697,1236,461,179.79509935512
"0247021016",1.62541960565351,3397,1876,1521,164.343660085783
"0247021017",0.707888837929539,1547,895,652,176.354406659521
"0247021018",1.56089115454206,3194,1843,1351,166.676071730059
"0247021020",0.818990658729179,2467,1082,1385,166.299460085782
"0247021021",2.83210035100129,3816,2173,1643,162.329890367771
"0247621008",2.92291234843791,3434,2178,1256,168.061934810702
"0247621040",3.00322366020341,3712,2181,1531,164.239584377094
"0247621041",0.584788503419362,2240,727,1513,164.537722547781
"0247621067",0.910352400381054,2787,1202,1585,163.25714503939
"0247621071",1.36568775648118,3671,1670,2001,150.961814503956
"0247921001",1.27934238688725,1693,1593,100,190.96349413759
"0247921004",0.564065276650372,1235,697,538,178.285018479881
"0247921014",0.483019891171955,2235,571,1664,161.767239777855
"0247921018",1.56628510039135,2448,1848,600,177.143449004484
"0247921021",1.2214074539088,2505,1533,972,172.001399418921
"0248121003",1.18122888925524,2286,1489,797,174.119874587314
"0248121011",2.51293965247144,4046,2143,1903,155.561366675459
"0248121024",0.468365070599655,2187,542,1645,162.302606144815
"0248121025",0.663632662201341,2907,841,2066,147.015812954561
"0248121033",0.00473529951924692,2139,39,2100,143.359143399008
"0248421010",1.21095727050612,3448,1522,1926,154.804946147512
"0248421013",0.702067917166055,1568,888,680,175.901566092342
"0248421015",0.357543158841537,2270,375,1895,155.870630965639
"0248421017",1.87264337046107,3908,1999,1909,155.272154763754
"0248421040",3.63969818882168,3838,2194,1644,162.317124587314
"0250521005",1.48941040326369,3248,1786,1462,165.298705960699
"0250521016",1.02062083123494,2187,1330,857,173.398004004788
"0250521017",1.11272444312144,3519,1416,2103,142.75359965464
"0250521024",1.61841496639342,3763,1872,1891,155.987838856599
"0250521026",0.55032536010957,1653,673,980,171.923833272128
"0251541001",1.38258293456337,2125,1694,431,180.182684073231
"0251541004",1.5083576694289,3356,1803,1553,163.854698239546
"0251541005",1.1841852551573,2406,1492,914,172.713031300938
"0251541007",0.76406878516034,2472,986,1486,164.939660199973
"0251541010",0.813226178694169,1155,1073,82,192.131586537101
"0252441037",0.00162750006403327,868,36,832,173.696280889592
"0252441038",0.43479357321509,800,490,310,182.72421640369
"0252441040",1.01211442273901,2714,1323,1391,166.250889332494
"0252441042",0.686098732745191,1602,871,731,175.108913897558
"0252441045",1.21959406011839,1970,1529,441,180.104519839728
"0252741018",2.19340731472124,2670,2106,564,177.703549502183
"0252741025",2.08878538686012,4082,2074,2008,150.636613624908
"0252741037",0.677964953609544,1670,859,811,173.95518069532
"0252741041",0.714216003704242,2148,906,1242,168.282049899934
"0252741044",0.424956248446347,1894,478,1416,165.980392580608
"0254041001",0.720149519332927,2097,914,1183,169.175347377215
"0254041008",1.47148110762675,2101,1769,332,182.202936013893
"0254041016",0.429118177383719,1715,485,1230,168.499517484648
"0254041026",0.172252478608066,1369,153,1216,168.716512461302
"0254041068",0.384044065406813,644,412,232,184.96830584029
"0254641001",0.655454205181988,1824,827,997,171.648158837014
"0254641007",0.185916087362344,1515,172,1343,166.792910924573
"0254641008",2.33641250513096,3910,2125,1785,159.025415666216
"0254641012",0.730353654377823,2103,931,1172,169.387264638584
"0254641017",0.828188492331258,2514,1094,1420,165.94960386847
"0255141011",1.2559038635757,3011,1571,1440,165.598371099864
"0255141020",0.267916390094459,284,267,17,199.814968310876
"0255141048",1.39838927912593,2961,1707,1254,168.092258499054
"0255141079",0.68579665897435,1493,867,626,176.632026760064
"0255141083",1.52210857613945,1930,1814,116,190.282999721897
"0258641006",2.23892230610877,3096,2112,984,171.824567482916
"0258641011",1.95989279066613,2459,2037,422,180.317633897009
"0258641081",1.66369254916084,2986,1902,1084,170.518756145501
"0258641082",0.712081926664969,1559,902,657,176.296612920602
"0258641084",1.00228171002752,2336,1314,1022,171.314560099187
"0260641002",0.0786552012536867,1686,72,1614,162.725397058669
"0260641019",0.908524493753353,3207,1198,2009,150.565723837903
"0260641022",1.31226766421949,3324,1624,1700,161.096708568641
"0260641042",0.982615226879408,2903,1292,1611,162.78708671067
"0260641051",2.75302076697335,3209,2164,1045,171.019658804377
"0260941014",1.20123283324987,2329,1509,820,173.811169870436
"0260941026",1.73995155055197,3162,1935,1227,168.574350649684
"0260941028",0.786015512305535,2233,1024,1209,168.784781916971
"0260941040",0.994873354853594,2781,1304,1477,165.033466733177
"0260941057",1.82081797417915,2534,1978,556,177.852890827161
"0261141015",0.643433026068664,1153,814,339,181.999193426728
"0261141020",0.761470284551118,2165,981,1184,169.166541855869
"0261141048",1.37009338663096,1916,1678,238,184.784210330696
"0261141049",0.47566161110573,2198,556,1642,162.330379103283
"0261141060",0.803472536876654,2326,1052,1274,167.724232478237
"0261741001",0.597061717272909,1693,742,951,172.214416767528
"0261741015",1.40232907160196,2726,1713,1013,171.421692042889
"0261741037",1.36789000911954,2989,1676,1313,167.231354915725
"0261741055",0.305433885689146,1914,311,1603,162.984791236274
"0261741059",1.40302098655613,3164,1715,1449,165.414609549608
"0262341016",0.82204468744371,2267,1087,1180,169.245682913791
"0262341020",1.33994121795714,2659,1650,1009,171.49381371087
"0262341022",0.296586807975844,2243,300,1943,154.073780889592
"0262341023",0.251076322397969,2055,249,1806,158.498874359397
"0262341025",0.31347253554922,1680,319,1361,166.602169808676
"0263741014",0.245820857629363,1832,246,1586,163.253780889591
"0263741037",0.408600652879569,1718,452,1266,167.968062429003
"0263741052",1.01442741177649,1534,1325,209,185.873813636744
"0263741072",0.235890467162185,2091,230,1861,156.851396165663
"0263741083",0.143743792746303,1173,126,1047,170.988854915725
"0263841043",0.209617872517664,2075,200,1875,156.662141247126
"0263841048",0.251882655179539,1375,251,1124,169.956007225671
"0263841064",0.730937135843044,948,932,16,200.424935159153
"0263841069",1.10116497366513,2674,1407,1267,167.93081623598
"0263841081",0.281708440241702,1081,282,799,174.100361996168
"0263941006",1.20807100580222,2923,1521,1402,166.176544974529
"0263941039",0.320817418363979,1295,324,971,172.002856332881
"0263941040",0.725482858513218,2986,924,2062,147.275544809527
"0263941052",1.23049724309451,2545,1543,1002,171.587369402731
"0263941080",0.485198052883623,1328,575,753,174.763115759565
"0264541003",2.00345081766868,3634,2051,1583,163.321309875204
"0264541008",1.52452976046781,2305,1817,488,179.231810272794
"0264541010",1.82138679442878,3380,1979,1401,166.17881765923
"0264541013",0.621329481846672,1186,778,408,180.514508829059
"0264541025",0.57963961684073,1158,718,440,180.105943271937
"0269641013",1.09763359799816,2555,1404,1151,169.611896355477
"0269641015",0.542262449425824,2708,663,2045,148.468232392601
"0269641023",1.79771278426913,2345,1963,382,181.07882949877
"0269641026",1.20651736438408,2705,1519,1186,169.124720935361
"0269641045",0.95092238004184,2772,1245,1527,164.272824825308
"0278641004",0.338634712136941,2339,349,1990,151.788187437739
"0278641032",0.337233715464676,2114,345,1769,159.510409717972
"0278641034",0.471463989885313,1333,545,788,174.221131060484
"0278641037",0.786764753239705,1200,1025,175,187.165427130028
"0278641076",0.646569691103028,2180,821,1359,166.625911282375
"0278741020",0.801081947386538,2931,1045,1886,156.29163050672
"0278741034",0.200754294259094,1045,185,860,173.377196896144
"0278741035",1.20230240185082,1798,1513,285,183.618560762652
"0278741050",0.502868248327159,2804,611,2193,64.9105805290423
"0278741052",1.3765876704272,3371,1686,1685,161.356224456471
"0279641009",0.0739373602453444,1997,70,1927,154.790534439478
"0279641014",0.0435293562487619,1572,52,1520,164.375085086358
"0279641035",1.56383325259317,3718,1846,1872,156.672720771847
"0279641055",1.17231425880207,1539,1485,54,194.188589949469
"0279641063",1.0265407492306,3377,1337,2040,148.839977347186
"0280041005",0.823355629238962,2516,1089,1427,165.867839717704
"0280041018",0.773348142556389,1557,1003,554,177.872665890418
"0280041019",0.175603615685512,807,161,646,176.378941026823
"0280041022",0.276810330560998,1088,274,814,173.846289355904
"0280041042",0.263526701909377,1493,262,1231,168.442020131785
"0280241009",1.55526893753248,2453,1840,613,176.855440176737
"0280241014",0.682510909451871,2008,863,1145,169.698236351362
"0280241019",1.0748712719214,1632,1379,253,184.219470911337
"0280241028",0.579920969271608,2328,719,1609,162.804520050688
"0280241051",0.75699385417757,2134,975,1159,169.486757340711
"0281241006",0.474902799826417,1015,555,460,179.809356512926
"0281241021",0.416962621492934,872,468,404,180.64987970362
"0281241024",1.64456180098453,3226,1891,1335,166.902565869415
"0281241039",0.487562200244015,1566,578,988,171.774430230797
"0281241085",0.702726612974665,2283,889,1394,166.229397884051
"0281741002",0.208030156351398,960,195,765,174.638639328344
"0281741021",0.747755166863962,1755,959,796,174.125482536081
"0281741031",0.386679238830397,917,417,500,179.044551257615
"0281741036",0.493173527828427,1084,587,497,179.110136662107
"0281741037",1.11559548094788,2375,1425,950,172.235396035654
"0283341007",1.16732182129166,1596,1478,118,190.117114833995
"0283341018",0.63252743423724,2246,793,1453,165.362280350179
"0283341021",0.491673701286778,2571,585,1986,151.921620877808
"0283341028",0.554538533888504,2527,679,1848,157.310328420319
"0283341030",0.44686935798596,1398,504,894,172.962603632859
"0283441013",0.0308488183931806,2110,46,2064,147.162114222924
"0283441029",1.52545393937855,2124,1818,306,182.942364833994
"0283441041",1.28983791277861,1887,1601,286,183.594306005732
"0283441042",0.607633926986655,2733,756,1977,152.369310824714
"0283441052",0.867880398314945,1952,1146,806,174.039621284228
"0283541015",1.65686934654774,2522,1898,624,176.677024428114
"0283541018",2.40059014194497,3721,2132,1589,163.230715450216
"0283541019",0.461260892252523,2136,528,1608,162.816264398267
"0283541024",0.770679307956189,1222,997,225,185.178242886246
"0283541057",2.21990532614997,3921,2110,1811,158.383236456254
"0283741042",1.16205713174792,3282,1474,1808,158.417494787319
"0283741060",0.640653298571373,2458,805,1653,162.103192834861
"0283741065",0.210658425364052,1945,202,1743,160.120834295584
"0283741067",0.826734381185047,2093,1092,1001,171.605912161439
"0283741069",0.387553185208494,711,419,292,183.378181628393
"0283841010",0.159622637441282,327,138,189,186.557018709624
"0283841029",1.39162191898122,2336,1701,635,176.510305420001
"0283841052",1.07614782365428,2480,1381,1099,170.282130639339
"0283841063",0.501480121315264,2599,605,1994,151.418958345543
"0283841066",0.983530299735403,1908,1294,614,176.833289319975
"0284041003",2.61289609334978,4023,2155,1868,156.74130928117
"0284041017",1.2285567814053,2539,1540,999,171.624591541359
"0284041019",1.11634703383112,2067,1428,639,176.445291079221
"0284041026",0.0477194982762333,352,54,298,183.173231353772
"0284041057",0.258189971890299,273,258,15,200.706947084422
"0284141007",1.64328390030789,1976,1890,86,191.958904563575
"0284141031",0.603206282893207,1519,752,767,174.570145476096
"0284141032",1.47974045645438,2586,1777,809,173.963566422739
"0284141048",1.38395309454761,2978,1696,1282,167.639562845506
"0284141050",1.90085510071084,3729,2007,1722,160.556748167724
"0284241003",0.447890564940136,1170,505,665,176.135952899787
"0284241004",0.379970363119051,1754,406,1348,166.716098863356
"0284241010",0.757509236975989,2633,977,1656,161.982612611513
"0284241026",0.793102554238928,1132,1035,97,191.066073053194
"0284241028",0.572709219466215,2630,712,1918,155.017654563576
"0286821005",0.408220234674427,1580,450,1130,169.846128668967
"0286821009",1.420587798204,1845,1730,115,190.412219034743
"0286821015",0.582476968774091,2324,722,1602,163.018801239957
"0286821019",0.578788981002855,1751,716,1035,171.131083142502
"0286821021",1.49866643767095,3306,1796,1510,164.649145105362
"0287841011",0.0492046851186428,849,56,793,174.166412252319
"0287841044",1.06662654727298,2200,1371,829,173.730619786537
"0287841057",0.321863123040503,1314,327,987,171.786729346216
"0287841065",0.227161339147643,1208,223,985,171.816517892361
"0287841069",1.94416586401535,3269,2025,1244,168.236851286491
"0288041015",0.385132325313699,926,415,511,178.843709805812
"0288041055",2.00046424630116,3905,2049,1856,157.068452595717
"0288041062",0.500198902291179,1023,599,424,180.284406091798
"0288041066",0.454966339067728,1816,517,1299,167.388859900159
"0288041078",0.560274842938816,1358,687,671,176.051910561677
"0288141001",0.705716587652351,2132,892,1240,168.305548471617
"0288141006",0.959721655962743,3389,1261,2128,139.036381923363
"0288141015",0.202286226685389,932,189,743,174.872978476005
"0288141019",0.377581912675553,1771,397,1374,166.424416522232
"0288141031",0.747939259457588,2833,960,1873,156.66991338242
"0288241004",0.749450623439351,2375,964,1411,166.008488320825
"0288241005",1.56963539650665,2174,1850,324,182.388369186809
"0288241011",0.149565193348577,2300,131,2169,127.643780889594
"0288241017",0.512195687536594,2590,626,1964,152.912712632822
"0288441005",0.697111346532778,2546,885,1661,161.82072546092
"0288441013",0.723065441578845,1104,919,185,186.628933831027
"0288441021",1.58178894112104,2484,1856,628,176.625760456958
"0288441026",0.421048446874658,2170,473,1697,161.161458899819
"0288441035",1.33230177949437,1687,1641,46,194.696582659042
"0288541002",1.18453649125379,2434,1493,941,172.393292410806
"0288541008",1.27042503300348,3654,1583,2071,146.713123980195
"0288541011",0.335032971035401,1151,341,810,173.960613060689
"0288541013",1.62099675619833,3604,1875,1729,160.447146342402
"0288541024",1.80530050399658,3138,1968,1170,169.402726817568
"0288741008",2.46713567581379,4001,2138,1863,156.822583248623
"0288741014",0.297444074147955,1758,301,1457,165.344010277105
"0288741026",1.81166835971563,4063,1971,2092,144.220427949953
"0288741035",1.0949148693407,3468,1400,2068,146.947679924091
"0288741040",1.20217615006723,3210,1511,1699,161.096728755606
"0289741001",1.65552337819128,2159,1897,262,184.027893320724
"0289741008",0.903536266678071,2476,1188,1288,167.525171944052
"0289741038",0.13580336039056,1617,117,1500,164.796394868595
"0289741046",1.44666104890638,2857,1747,1110,170.121637106214
"0289741048",0.420592783406648,920,470,450,179.94600281196
"0289841009",0.611899791305082,2434,759,1675,161.645769926987
"0289841011",0.812109775567504,1783,1070,713,175.481021537212
"0289841023",1.05318638465159,2985,1357,1628,162.516107568594
"0289841032",0.787063628764575,2932,1027,1905,155.534904906998
"0289841057",1.22694057867756,3614,1537,2077,145.866394077857
"0290041025",0.242145148642671,453,243,210,185.802662961117
"0290041046",0.754784345145713,1328,969,359,181.549109550055
"0290041065",1.7267764731133,2264,1933,331,182.228256291296
"0290041068",0.547942650631961,1152,669,483,179.315978651937
"0290041079",0.102989086375151,1236,94,1142,169.708928046043
"0290141005",0.9639258395278,1572,1265,307,182.822501988579
"0290141010",1.25569298797465,2259,1570,689,175.805057902218
"0290141015",1.12762812831145,2784,1435,1349,166.699274770558
"0290141026",0.490904257645941,1129,584,545,178.149392987978
"0290141042",0.474770414793661,1358,554,804,174.043626373457
"0290241004",1.83082596661436,2145,1982,163,187.733301280663
"0290241030",0.685828820586941,1487,868,619,176.781760583853
"0290241032",1.7984460228816,2676,1965,711,175.506822084529
"0290241042",0.627706855277513,877,787,90,191.472685015628
"0290241054",0.805756358849258,1962,1058,904,172.838205779989
"0290341007",0.938631021599418,2924,1234,1690,161.302890719818
"0290341012",1.49144705089276,2368,1788,580,177.430261300121
"0290341025",1.34898405056195,2150,1658,492,179.182583523654
"0290341057",2.03162784027374,4003,2058,1945,153.959902890709
"0290341111",2.52677392073695,2821,2145,676,175.975848058043
"0290441032",1.50792720963917,3350,1802,1548,163.980968472356
"0290441060",0.922035361896322,1723,1214,509,178.851984489609
"0290441064",1.14971874809066,2383,1457,926,172.587540917432
"0290441080",0.092421365071906,1250,79,1171,169.392150281637
"0290441081",0.459284632956038,2344,525,1819,158.187207714672
"0290541004",1.30756800223647,2378,1617,761,174.670523427264
"0290541005",1.01159587638722,1400,1321,79,192.280326884324
"0290541007",1.29326251175424,3694,1605,2089,144.536202520142
"0290541054",1.82700692639788,3868,1980,1888,156.051041170039
"0290541055",0.521247407255149,1025,638,387,180.894903222937
"0290641019",0.121163387080065,1371,106,1265,167.97821155619
"0290641046",0.0381788308870687,2100,51,2049,148.082452478471
"0290641061",0.618777442113402,1487,772,715,175.420611783608
"0290641081",1.90112315385442,2283,2008,275,183.72458707014
"0290741029",0.899713766274358,2620,1182,1438,165.650091123138
"0290741031",0.640665938209243,2827,806,2021,149.729768391779
"0290741035",1.29850204197319,3775,1610,2165,129.076778115557
"0290741046",0.379819933108707,1237,404,833,173.676607263731
"0290741063",0.723914864982666,2872,920,1952,153.442072181214
"0290841001",0.377767938077572,2338,398,1940,154.152431999605
"0290841002",0.41158229164138,1756,460,1296,167.422239868826
"0290841008",0.0913049322818256,1279,78,1201,168.907444477605
"0290841009",1.12446142783207,1467,1434,33,196.130149812904
"0290841053",1.97304422717535,3448,2040,1408,166.047863757398
"0291041008",1.17869558390261,3283,1488,1795,158.737425433218
"0291041021",0.137037056703211,803,119,684,175.889543952282
"0291041028",1.45760209491481,3834,1756,2078,145.805656990759
"0291041056",0.616957092554226,2676,768,1908,155.280883743266
"0291041065",1.41888508971188,3404,1726,1678,161.533593806865
"0291141022",0.602019442835008,2115,750,1365,166.574118795377
"0291141026",1.31163506498386,3344,1623,1721,160.583106043032
"0291141043",1.51855106111289,3790,1809,1981,152.213380620003
"0291141053",0.334311313005222,1877,339,1538,164.127108352482
"0291141061",0.583503091907257,2345,725,1620,162.605853161717
"0291241002",1.00386285625714,2554,1316,1238,168.328826828343
"0291241026",0.069811597894919,982,66,916,172.690397709698
"0291241030",1.34045484300731,3642,1653,1989,151.821600637242
"0291241031",1.09109263616462,2811,1394,1417,165.977764839961
"0291241034",0.964931969887708,2709,1267,1442,165.562745122655
"0291341008",0.618658507636578,1535,771,764,174.638994038705
"0291341009",1.84279649101715,3789,1986,1803,158.520383114329
"0291341023",0.74944670080083,1585,963,622,176.693711678451
"0291341047",0.201556918614747,1282,187,1095,170.311548540117
"0291341054",1.01562491392514,2295,1327,968,172.020104884818
"0291441018",0.539696070454962,714,661,53,194.202409278662
"0291441031",1.25423460017813,3329,1567,1762,159.687270437057
"0291441034",1.94242565644636,2768,2024,744,174.86342297238
"0291441053",2.35493145694469,4074,2127,1947,153.877940987605
"0291441054",0.722196589958348,1335,917,418,180.383368107213
"0291541008",0.778253574375478,1551,1012,539,178.257771824734
"0291541018",0.416335414344204,1307,465,842,173.540121057996
"0291541057",1.16094685750051,2035,1473,562,177.732465087799
"0291541064",0.828929864688368,1124,1097,27,197.493136062889
"0291541082",0.860944912430818,1322,1141,181,186.848364833998
"0291641036",1.49550134304566,2865,1793,1072,170.674978201462
"0291641039",1.71092676739482,3119,1922,1197,168.958122191111
"0291641053",1.19258885520506,1670,1499,171,187.273250321883
"0291641055",0.691698795453493,1456,878,578,177.472599415981
"0291641065",2.60718610764354,3922,2154,1768,159.532592767544
"0291741030",0.844320826161853,2692,1116,1576,163.438706054632
"0291741056",0.512651438265211,1564,629,935,172.493680820903
"0291741073",1.35484223794287,3036,1663,1373,166.45278172356
"0291741078",0.143626989763647,646,125,521,178.649373502411
"0291741097",0.40457160830229,1385,441,944,172.346024456261
"0291841031",0.870316347727311,1847,1148,699,175.696711741801
"0291841043",0.919731338776981,1732,1213,519,178.685651478061
"0291841057",2.20723491455189,4152,2108,2044,148.531002897467
"0291841066",0.424618277738989,1914,477,1437,165.668949170951
"0291841089",0.640994745615616,2357,808,1549,163.955258621828
"0291941001",0.889783551680164,2175,1171,1004,171.5448224153
"0291941034",0.681368060279911,1453,861,592,177.276808307123
"0291941039",0.199775582381725,264,183,81,192.243186959095
"0291941052",0.350585740742395,1370,365,1005,171.539227279477
"0291941077",1.63521569829657,2893,1882,1011,171.471328541359
"0292041021",1.11424142812226,2197,1420,777,174.392484924049
"0292041034",1.92640737589797,2752,2017,735,175.052619748919
"0292041037",0.0992496142359039,1720,88,1632,162.446413173611
"0292041048",1.86148234252834,3337,1995,1342,166.815000794483
"0292041065",2.16383103092052,4057,2099,1958,153.160010052037
"0292141016",0.603620448560473,2487,753,1734,160.33763345899
"0292141017",1.11754906172412,3526,1430,2096,143.958435739646
"0292141035",0.263817499327009,956,263,693,175.750891247125
"0292141042",1.12997723405534,1823,1439,384,180.995146579596
"0292141062",0.372885757637178,441,391,50,194.342479365793
"0292241070",1.32869681361645,3083,1636,1447,165.464784315922
"0292241073",0.598924209232928,2882,744,2138,136.657017648463
"0292241086",0.714290149540507,2227,907,1320,167.120432341353
"0292241112",1.80213500580454,2669,1966,703,175.585793009538
"0292241116",1.59032109842215,2166,1861,305,183.025610803
"0292441003",0.52176999052687,1938,640,1298,167.395663320352
"0292441009",1.32576672961744,2408,1634,774,174.43428671987
"0292441018",1.81843770559631,3348,1977,1371,166.474519567368
"0292441021",1.09110807845796,2018,1395,623,176.689273932009
"0292441043",0.177327404755574,1894,164,1730,160.400443096008
"0292641012",1.10606123310281,2291,1410,881,173.127162819285
"0292641022",0.70795568777407,2240,896,1344,166.784896833243
"0292641026",0.208980034563329,554,197,357,181.562053352935
"0292641030",0.878391586113311,2721,1153,1568,163.579748071984
"0292641047",0.379699159187766,1570,403,1167,169.451863042672
"0292741011",1.26185165028476,2790,1577,1213,168.761852135043
"0292741026",1.20443992005643,2278,1516,762,174.648711474384
"0292741032",0.625335711846569,1976,783,1193,169.002458130846
"0292741049",0.677625938522599,933,858,75,192.392503091476
"0292741062",0.756826860288341,1282,974,308,182.807481216285
"0292841006",0.784128234906814,1363,1021,342,181.925818329664
"0292841013",1.99505506365509,2262,2046,216,185.627833159601
"0292841016",0.213036420416163,2330,204,2126,139.470826830137
"0292841037",1.37249854164108,2081,1682,399,180.71344133953
"0292841093",0.08858142351246,183,75,108,190.755334295585
"0292941004",1.95801170324515,2131,2035,96,191.092308765392
"0292941010",0.466701580019673,931,538,393,180.851975500225
"0292941021",0.563417024151793,867,695,172,187.241488528798
"0292941026",1.55627917904081,2398,1841,557,177.844550678844
"0292941028",0.410981220152101,1105,457,648,176.37257981016
"0293041030",1.37861058092162,2323,1691,632,176.589668451949
"0293041063",0.518160856643123,1427,635,792,174.176611131269
"0293041075",2.27652315665007,3871,2114,1757,159.827140664858
"0293041083",1.17272848405161,3121,1486,1635,162.40834258736
"0293041091",1.62612432700298,1924,1877,47,194.492877033487
"0293141002",0.636239317303816,1573,798,775,174.411234944779
"0293141012",1.23899119627694,2950,1551,1399,166.180665641989
"0293141037",0.798935230511793,1331,1043,288,183.562405957293
"0293141063",1.11003823265378,1907,1414,493,179.153213898232
"0293141064",0.918264920595174,1283,1212,71,192.917198239547
"0293241038",1.20464705284232,3625,1517,2108,142.324121688165
"0293241043",0.81417252023133,2858,1076,1782,159.19473290741
"0293241056",0.662150467129284,1365,838,527,178.498465012441
"0293241063",0.102086728923678,1141,92,1049,170.970247361985
"0293241075",1.43609492084077,2900,1743,1157,169.557526566828
"0293341012",0.508937155074856,1569,620,949,172.250593937213
"0293341024",0.38457990662004,1732,413,1319,167.122583964236
"0293341025",0.802229440646477,2071,1047,1024,171.299206995879
"0293341028",0.986222053685542,2003,1298,705,175.572419960905
"0293341032",1.2177762300369,3263,1527,1736,160.217970133472
"0293441006",0.743184234935138,2488,953,1535,164.184485549454
"0293441016",0.4893333410108,2732,583,2149,134.479527693067
"0293441022",1.9109453506765,4033,2011,2022,149.72061127568
"0293441043",1.07677582715868,2705,1382,1323,167.082519828384
"0293441053",2.89198635268155,2578,2176,402,180.670011506892
"0293541005",1.25250068890815,3317,1564,1753,159.874547127953
"0293541016",0.253560473005181,1463,255,1208,168.797962268311
"0293541032",1.77532368932367,4045,1950,2095,144.082080695319
"0293541063",0.548654021937581,1676,670,1006,171.534668492087
"0293541064",0.591885949493772,2177,738,1439,165.634577403987
"0293641005",0.0448844879247108,1725,53,1672,161.669053672699
"0293641016",1.4198491189869,2987,1729,1258,168.044356685302
"0293641019",0.862447217178389,2656,1142,1514,164.494538492598
"0293641024",1.02421060647897,1980,1335,645,176.386644343368
"0293641032",0.65602299287986,2471,831,1640,162.34392547369
"0293741003",1.43418548897413,3323,1741,1582,163.322141638789
"0293741005",0.506977520015331,2197,617,1580,163.331031508457
"0293741036",1.29288599926726,2491,1604,887,173.005054294006
"0293741046",0.374576758860196,1607,393,1214,168.751042308292
"0293741047",0.470901609078681,2634,544,2090,144.487490453344
"0293941006",1.14981289596679,1761,1458,303,183.060052436124
"0293941007",0.742243652388866,1720,950,770,174.520855744494
"0293941053",1.54217703095779,2943,1831,1112,170.097166859255
"0293941061",2.17413598240969,2472,2100,372,181.233950076554
"0293941068",1.30878484334901,2143,1619,524,178.580160935471
"0294041020",0.706018668421739,2136,893,1243,168.247478519906
"0294041022",0.517354680259739,2356,632,1724,160.539824250423
"0294041031",1.01309813185015,2103,1324,779,174.332228645301
"0294041032",0.428667834776556,1846,483,1363,166.600529725858
"0294041043",2.31680291152039,3202,2120,1082,170.54221325573
"0294141033",0.797846558596651,1881,1041,840,173.57364166357
"0294141034",0.538316226557639,786,659,127,189.454552819387
"0294141038",0.428591267346532,1673,482,1191,169.088360348968
"0294141055",0.812187012571804,1573,1071,502,179.011314970338
"0294141059",0.235887581358565,1135,229,906,172.835236504
"0294241002",0.668494579305378,2136,847,1289,167.476458034741
"0294241004",0.378075055274373,1543,399,1144,169.699214546635
"0294241042",0.835170854929371,3090,1108,1982,152.174550532395
"0294241089",1.04620582234752,1464,1354,110,190.628166080072
"0294241090",1.31768162308674,3417,1628,1789,158.861965920626
"0294341031",0.323589486790624,1835,329,1506,164.710516184068
"0294341036",1.42233874030127,2767,1731,1036,171.130658849274
"0294341042",1.39481873408187,2287,1704,583,177.39635370825
"0294341043",0.501433638938361,2367,604,1763,159.677820155147
"0294341056",0.321788696604446,648,326,322,182.460204997991
"0294441001",0.511953219936713,2709,624,2085,145.244472863787
"0294441002",1.14881509501359,2633,1456,1177,169.303664436824
"0294441006",1.36857499086523,1944,1677,267,183.883794161872
"0294441016",0.948001523542169,2701,1241,1460,165.309662552383
"0294441029",0.565868868824332,2728,700,2028,149.374094458648
"0315121013",0.0656188291114593,2257,63,2194,56.6806930384575
"0315121047",0.164125507271526,2289,141,2148,134.724871564213
"0315121053",1.35547873121727,3841,1664,2177,124.577152971915
"0315121059",0.635205184995286,2929,796,2133,137.533881384372
"0315121076",0.461354377967986,2681,529,2152,133.148583398654
"0315421024",0.880505135729887,1770,1158,612,176.866638924697
"0315421038",3.02550762169368,3018,2182,836,173.610430939594
"0315421048",1.54179326055618,3399,1829,1570,163.57112366271
"0315421051",1.73519067006839,3390,1934,1456,165.347284811509
"0315421063",1.68882801524099,3945,1913,2032,149.20625533102
"0315521009",0.281162901336032,2355,280,2075,146.19661303012
"0315521010",0.80624956024326,2620,1059,1561,163.694850777914
"0315521013",1.12907375711444,3567,1437,2130,138.724913249229
"0315521017",0.656880275189874,1936,832,1104,170.230219676178
"0315521031",0.765422033423393,2615,989,1626,162.543028585424
"0315621003",0.530148052821022,2494,650,1844,157.414043980965
"0315621005",0.939218315631884,3149,1235,1914,155.163994513697
"0315621048",1.83240120864656,3830,1983,1847,157.314524198163
"0315621058",2.82950904055817,4169,2172,1997,151.118760317664
"0315621064",2.38273573061245,4211,2131,2080,145.703557865373
"0316221007",1.23692667852235,3243,1549,1694,161.268402010753
"0316221015",0.0856332084629265,1875,74,1801,158.564989721063
"0316221021",0.673192835703912,2923,853,2070,146.896673923601
"0316221038",1.06004981043028,2019,1365,654,176.349307583116
"0316221044",1.81575595586513,3877,1975,1902,155.572932492908
"0317121004",0.472295732779119,2195,547,1648,162.249736964024
"0317121011",0.280032385227452,1015,279,736,175.038942222904
"0317121013",0.216071933969953,1427,212,1215,168.747910036415
"0317121016",1.37780884887172,3502,1690,1812,158.380766407029
"0317121020",1.39756512888759,1775,1706,69,193.272236964023
"0318621003",0.337056293871778,1763,344,1419,165.974791883158
"0318621008",0.876305834353222,2638,1151,1487,164.936003205467
"0318621024",0.904684994256418,2326,1191,1135,169.749044085267
"0318621031",0.496779767299162,1518,594,924,172.603192111519
"0318621042",0.925041933901932,2083,1218,865,173.315042234118
"0319821003",1.37932857579951,3080,1692,1388,166.262272463273
"0319821022",0.495446185097676,1378,591,787,174.238070721973
"0319821047",1.49038013156675,2122,1787,335,182.125769665575
"0319821050",0.570650786469226,966,706,260,184.14234311479
"0320121003",0.589679013870989,1170,735,435,180.145577491378
"0320121007",1.09717757206424,2626,1402,1224,168.625232879504
"0320121011",1.79519268120759,3812,1961,1851,157.265784676628
"0320121026",0.960571641196463,1825,1262,563,177.711198252741
"0320121029",1.43924322211983,2342,1744,598,177.17947749138
"0320221001",0.125954965148208,1816,110,1706,160.96844000938
"0320221004",0.584966752933796,2307,729,1578,163.423293419117
"0320221016",1.337357114313,2928,1647,1281,167.650477491379
"0320221034",1.0395424930026,3174,1351,1823,158.059805470845
"0320221036",1.3393481488854,3559,1649,1910,155.265103920064
"0320421039",1.23279285543485,3578,1545,2033,149.183203143968
"0320421043",0.869597878747247,1851,1147,704,175.58261243211
"0320421048",0.264572004962114,951,264,687,175.832134290703
"0320421049",0.512255955635504,2756,627,2129,138.951395329884
"0320421059",1.67477380911464,2482,1906,576,177.506397289432
"0325121005",3.17287722559216,2475,2185,290,183.449446128728
"0325121010",1.14045422061206,3216,1450,1766,159.613998831705
"0325121022",0.120948370171869,1633,105,1528,164.271432139371
"0325121027",1.31511040642325,2115,1625,490,179.225199439543
"0325121037",0.457620193688677,977,521,456,179.896338839446
"0326421008",0.299564310506497,971,304,667,176.085695713505
"0326421012",1.74493146284203,3433,1938,1495,164.834674526264
"0326421018",0.600319964719912,767,748,19,199.377483750386
"0326421023",0.782139445183549,2080,1018,1062,170.814373121037
"0326421025",0.891713693092338,2316,1173,1143,169.707526646343
"0327021015",1.0109130126766,3002,1319,1683,161.380984433069
"0327021019",0.848937802760674,1867,1122,745,174.818733143964
"0327021058",0.224042660935281,1234,220,1014,171.413690253755
"0327021060",0.987096954736807,1794,1299,495,179.129372019915
"0327021065",0.724110576458508,1180,921,259,184.156772291475
"0329221015",1.76997357931758,3285,1947,1338,166.880964717704
"0329221020",2.11746763110799,3467,2084,1383,166.312001164502
"0329221021",1.65370889216757,2811,1896,915,172.697770859378
"0329221041",0.177035367496616,285,163,122,189.894988421096
"0329221044",1.27668357951315,2059,1588,471,179.630140542286
"0329821001",1.11785287289945,3234,1432,1802,158.543703766327
"0329821050",0.810688086042605,1958,1069,889,172.992214490375
"0329821065",1.05961484591336,3199,1364,1835,157.728192000883
"0329821075",0.120018470318371,281,104,177,186.93425416703
"0329821077",0.714367252802246,1298,908,390,180.868458258003
"0330421010",4.22759571212749,3299,2196,1103,170.235327254067
"0330421013",0.55361578386254,2579,678,1901,155.626675042323
"0330421031",0.37841843464344,1062,400,662,176.202968271818
"0330421061",2.12881534766411,2389,2088,301,183.073082627258
"0330421078",0.300733348326995,632,306,326,182.350404181345
"0330821027",0.655870584500561,1282,829,453,179.90530006651
"0330821030",0.366060735780908,1094,386,708,175.523813017916
"0330821058",0.982638943830569,2966,1293,1673,161.665647713162
"0330821061",1.2077672107479,2658,1520,1138,169.727685305914
"0330821067",2.08715122447568,3592,2073,1519,164.378028446016
"0330921006",0.399606139371654,809,438,371,181.260822233696
"0330921018",0.379863661279103,1557,405,1152,169.605270440933
"0330921028",0.615816589963612,2172,763,1409,166.034624587314
"0330921032",1.30450556645342,2711,1614,1097,170.299027693067
"0330921046",0.454911001578578,582,516,66,193.458575195401
"0331421031",0.639842905651392,1462,803,659,176.278526306562
"0331421038",0.744818826636692,1307,954,353,181.645055023953
"0331421041",2.14293193168789,3287,2091,1196,168.965387023154
"0331421046",1.95295968329251,3487,2029,1458,165.324493665016
"0331421052",3.45629401015053,3495,2192,1303,167.345423512507
"0332121006",0.731028298740408,2183,934,1249,168.208592647517
"0332121009",0.795341162061371,2035,1037,998,171.63511880096
"0332121024",0.809315506236507,1168,1065,103,190.895020771174
"0332121025",0.93799339930363,1630,1233,397,180.736862892752
"0332121027",0.88676002715949,2624,1165,1459,165.316684910798
"0332221008",0.524942672227729,1797,644,1153,169.572670461768
"0332221017",0.420991566367101,1936,472,1464,165.271337022689
"0332221018",1.21997387484544,2626,1530,1096,170.304454446843
"0332221026",0.826873927988616,2526,1093,1433,165.707442989119
"0332221034",0.0706386931863742,1812,67,1745,160.109051565793
"0332921033",0.828279917551089,1147,1095,52,194.220125813073
"0332921035",0.599738416173521,2402,747,1655,161.996493831224
"0332921079",1.7514475701296,2013,1941,72,192.860552899279
"0332921093",0.488982805574941,928,582,346,181.856831726268
"0332921133",0.265760172899389,1881,265,1616,162.698780889591
"0334221011",1.6911151174151,2264,1915,349,181.82709327112
"0334221017",1.08157092294724,1801,1387,414,180.482227565237
"0334221021",0.712357746520695,2089,904,1185,169.149889752106
"0334221053",1.35036398231862,1697,1660,37,195.784700464066
"0334221058",1.30345556959031,2163,1613,550,177.963219417037
"0334421019",0.858834792539665,1775,1137,638,176.452376013647
"0334421052",0.640673225782228,2062,807,1255,168.062980444039
"0334421055",1.33403540250852,1834,1644,190,186.509478849702
"0334421058",1.13949339493496,2180,1448,732,175.098952715137
"0334421065",0.916590317610571,2794,1207,1587,163.246799045442
"0335121013",0.966052647672212,2105,1271,834,173.668218933979
"0335121031",5.12159082261053e-13,2208,22,2186,110.765410541235
"0335121034",5.54839367301246e-13,2207,28,2179,119.113521300011
"0335121045",1.43349597912047,3124,1740,1384,166.308297689273
"0336221044",0.501398166719077,1734,603,1131,169.773224705206
"0336221052",0.710783509372684,1596,900,696,175.716360645017
"0336221053",2.57240917568155,3903,2151,1752,159.918166523475
"0336221064",0.90865740859192,1346,1199,147,188.451175990672
"0336221081",0.715157439089063,950,909,41,195.124419067619
"0337021024",2.64099217718617,2881,2158,723,175.322355807003
"0337021028",0.282226501076788,1690,283,1407,166.061826152733
"0337021036",1.06253605752901,1703,1369,334,182.137391956121
"0337021037",0.633246659139839,1870,795,1075,170.665481856957
"0337021038",1.60837321989871,2189,1870,319,182.494575802895
"0339021002",0.107330332851638,747,98,649,176.370618198196
"0339021017",0.959337894677625,2116,1258,858,173.392261697516
"0339021019",1.2354162630268,3107,1547,1560,163.770246639831
"0343421013",0.431772757210585,2083,488,1595,163.122260898786
"0343421014",0.506915148926064,2397,616,1781,159.203734639321
"0343421029",0.181555449838176,625,170,455,179.899777217705
"0343421035",0.468492566755518,1350,543,807,174.00156211331
"0343421040",0.209678389903396,342,201,141,188.760797367827
"0344521018",0.834499938116214,3047,1106,1941,154.097511273542
"0344521020",0.853659533254863,2995,1130,1865,156.812856577355
"0344521043",0.883698210687217,1778,1161,617,176.822997406072
"0344521063",0.390907654780226,1145,427,718,175.38928911583
"0344521082",1.035411602937,1858,1348,510,178.847070373897
"0345021015",0.852208822587464,1735,1129,606,177.002071196514
"0345021021",1.03622909037849,2635,1350,1285,167.606215031175
"0345021030",0.411663852759831,1336,461,875,173.186806995879
"0345021064",0.407830382135757,1158,449,709,175.519130371969
"0345021076",0.479538139503466,2071,566,1505,164.731320671795
"0345321023",0.458506453301528,1138,523,615,176.825283244465
"0345321024",0.573761359298917,1683,713,970,172.012860674309
"0345321038",1.15661649039716,2430,1467,963,172.057233704093
"0345321041",0.52398300613042,1285,642,643,176.419948903063
"0345321042",0.251367704304766,1682,250,1432,165.724478785803
"0345421008",0.353097845053627,1778,368,1410,166.030091694711
"0345421021",2.36799061106579,2848,2128,720,175.360701768166
"0345421026",2.29672954086418,2345,2116,229,185.04957972225
"0345421032",4.29871347640737e-13,2154,18,2136,137.425227544978
"0345421058",0.571715754215373,2422,709,1713,160.717728641291
"0345721017",0.635891012794003,2058,797,1261,168.000899432837
"0345721035",0.410793476821266,1477,456,1021,171.318694359734
"0345721043",1.40190524048541,3490,1712,1778,159.225480941662
"0345721054",0.386898912141342,804,418,386,180.914129690646
"0346121015",1.47373150110474,3290,1772,1518,164.40791572604
"0346121017",0.95945639431068,2220,1259,961,172.062714724934
"0346121027",1.75719864093642,2300,1944,356,181.578311028722
"0346121028",1.15413261718062,1622,1464,158,187.878551322775
"0346121035",1.26746736222312,2789,1582,1207,168.828391461483
"0346321019",0.913085005717109,2079,1203,876,173.186652346665
"0346321020",1.56604352815862,3883,1847,2036,149.014070583464
"0346321037",1.1643797854601,3405,1475,1930,154.599956156725
"0346321057",0.821837207237687,3092,1086,2006,150.723321864623
"0346321064",1.26571553333094,3662,1580,2082,145.511994322711
"0347221001",4.04382530584046e-13,2210,15,2195,40.5355077595868
"0347221004",0.501809715058676,1699,608,1091,170.404905778695
"0347221016",0.00102029685189141,46,35,11,202.820122393441
"0347221018",9.84338994835106e-14,6,5,1,265.752151237948
"0350521011",0.350699474370324,2548,366,2182,116.769557528817
"0350521039",0.527707698540107,2635,647,1988,151.871318614306
"0350521050",0.644986548447574,2898,817,2081,145.647552645463
"0350521057",0.466274608036167,2674,537,2137,136.657155244795
"0350521063",0.835906883692434,3280,1110,2170,127.313013291426
"0351821004",1.69346365816574,1981,1917,64,193.513479095667
"0351821010",0.471798862867596,2263,546,1717,160.65164601199
"0351821014",1.99353175405181,4217,2045,2172,126.626193419118
"0351821019",0.711680076032712,2698,901,1797,158.708831336845
"0352221018",1.44246322622795,3163,1745,1418,165.977218894587
"0352221029",0.37673118075761,1704,394,1310,167.263318858708
"0352221041",0.357491997438887,392,374,18,199.713327600266
"0352221042",0.435203901165324,2429,491,1938,154.231446220676
"0352221044",0.39027566629265,1560,424,1136,169.744726154336
"0361821004",0.238435919530292,2056,236,1820,158.174455056166
"0361821006",0.298521576150935,832,303,529,178.462205949409
"0361821030",0.670635692386834,1334,849,485,179.2638313975
"0361821042",0.895128257578281,1623,1176,447,180.02773178268
"0361821063",0.237580535223431,529,233,296,183.292673475606
"0363621002",0.946063252191595,2604,1240,1364,166.576442879286
"0363621016",0.494670573849744,729,589,140,188.912508400544
"0363621019",1.33270485766826,2189,1642,547,178.056586400945
"0363621021",0.745690061379449,2605,956,1649,162.209582305602
"0363621022",0.820266322166834,2709,1084,1625,162.564661067399
"0364221002",0.241631939357134,1174,241,933,172.528553009511
"0364221008",0.979898949976681,2358,1289,1069,170.702288091638
"0364221011",0.440709940467113,1337,499,838,173.579066999916
"0364221014",0.354359119429219,716,369,347,181.841574917732
"0364221018",0.319968617507785,1128,323,805,174.041250318058
"0365121001",0.0570869189815696,1339,60,1279,167.680045055109
"0365121004",0.209421262970356,2319,199,2120,140.619079592082
"0365121008",0.316236186088173,495,321,174,187.193048590031
"0365121017",2.47880252193105,4195,2140,2055,147.627994185836
"0365121021",0.488583791967776,2077,581,1496,164.832823838292
"0365821004",0.110172743819325,1359,102,1257,168.055059946394
"0365821009",0.776019074166785,2689,1007,1682,161.395734982079
"0365821015",1.3967628317285,3065,1705,1360,166.621277846509
"0365821019",0.667236331508614,2145,845,1300,167.38747162825
"0365821020",0.85384739193616,1980,1132,848,173.502039688593
"0377121001",0.422832910677346,2153,476,1677,161.543943741214
"0377121002",0.830073979296862,2435,1099,1336,166.889904906998
"0377121017",0.767891588326681,2974,994,1980,152.31054794226
"0377121041",1.16634964076915,2431,1477,954,172.13988559612
"0377121052",0.512046215042427,2425,625,1800,158.56875554794
"0377321002",0.803526795752976,2801,1054,1747,160.048935289085
"0377321004",0.644827757428588,1334,816,518,178.718377723552
"0377321015",1.01815914557899,1911,1329,582,177.412521527748
"0377321055",2.52099789577909,2423,2144,279,183.695242585399
"0377321066",0.661424867674276,1726,836,890,172.989703957451
"0377421002",0.499332803982025,1663,597,1066,170.75715365923
"0377421004",0.541379765056004,2448,662,1786,158.96074130302
"0377421008",1.27760783583271,3101,1589,1512,164.584745894758
"0377421011",1.11535057329796,3470,1424,2046,148.343452094482
"0377421017",0.517498101248335,2098,633,1465,165.254933983018
"0377521002",1.65921641499144,2350,1899,451,179.921831235069
"0377521006",0.758919131431699,1491,979,512,178.825614552273
"0377521031",1.25682168913953,3006,1572,1434,165.707128201975
"0377521034",1.59776956928465,3278,1866,1412,165.988879960965
"0377521042",1.15950310667035,1909,1472,437,180.118955056167
"0378421011",0.19039038080024,1491,176,1315,167.202440253756
"0378421031",1.49336436623431,3949,1789,2160,129.499915726001
"0378421034",2.6916907467015,2431,2161,270,183.785090212824
"0378421041",0.627080289427597,1687,786,901,172.859562072939
"0378421058",1.48046554547367,2699,1779,920,172.616723077826
"0378821017",0.458136712050539,2409,522,1887,156.052231920422
"0378821018",0.43549863134659,1632,493,1139,169.722783801674
"0378821037",0.570736532679351,859,707,152,188.062980941661
"0378821049",1.67328792163331,3723,1905,1818,158.210076798343
"0378821066",0.797547705783875,1429,1040,389,180.882450573547
"0379021002",0.174909159471841,208,159,49,194.34818931156
"0379021009",0.235059784065205,1180,228,952,172.165248533427
"0379021045",0.281460936526929,393,281,112,190.552057789804
"0379021074",0.288029152290887,683,292,391,180.86304297237
"0379021077",0.896314440889117,1199,1178,21,198.487073959544
"0379221001",0.725221803057989,2338,923,1415,165.980691116967
"0379221017",1.79498862180395,4091,1960,2131,138.447083549335
"0379221033",1.66157491520106,3351,1901,1450,165.413447258507
"0379221036",1.2860874359809,3710,1600,2110,141.754588744023
"0379221043",0.0134732048321882,2216,41,2175,124.875376472478
"0379721001",0.564980902399615,1769,698,1071,170.680941664507
"0379721009",1.65139716933027,2314,1893,421,180.317905100052
"0379721010",0.39042801170248,571,426,145,188.504365594877
"0379721016",1.37721664511681,2183,1689,494,179.1393372757
"0379721022",1.48326472223487,1974,1783,191,186.496957920647
"0380121003",3.4422666029649,2645,2191,454,179.900940226912
"0380121026",1.12961334917225,2503,1438,1065,170.78668048403
"0380121046",1.452932615224,2232,1751,481,179.3286928681
"0380121048",0.311729320843711,1853,317,1536,164.166129175868
"0380121065",1.09880181656242,2127,1406,721,175.330064920831
"0380321023",0.617223581277434,1206,770,436,180.139075440652
"0380321024",0.80724769348387,1199,1062,137,189.093920063515
"0380321026",2.72460022276452,2521,2163,358,181.5605756696
"0380321048",0.215708312604951,1783,210,1573,163.477555646589
"0380321052",0.265820300864195,1513,266,1247,168.218254945645
"0380421003",0.686268533695355,1586,872,714,175.422512000404
"0380421007",0.229550271318846,1073,224,849,173.482064376366
"0380421008",1.99584671980756,3861,2047,1814,158.292413296398
"0380421010",1.38503441413954,3123,1697,1426,165.868780326442
"0380421025",0.924003220657164,2489,1217,1272,167.815605921618
"0381021054",0.738738217782869,1289,946,343,181.910886114372
"0381021056",0.667833505635892,934,846,88,191.905445106862
"0381021057",1.86678896683936,2896,1996,900,172.870633273321
"0381021059",0.692351491085404,2778,880,1898,155.775556272556
"0381021067",0.638116172284031,2653,800,1853,157.218034095792
"0381321002",0.473247111399917,2225,549,1676,161.616330733759
"0381321003",0.915833036190835,1669,1205,464,179.739428610541
"0381321008",1.24591138051019,3676,1554,2122,140.54569910676
"0381321009",0.149087339437822,140,130,10,204.356310824715
"0381321037",0.387762233707545,719,420,299,183.157831123701
"0382421015",0.379142217549149,1228,401,827,173.738903401597
"0382421018",0.253051569275403,535,253,282,183.685570297357
"0382421025",0.821061290820872,1130,1085,45,194.708402211933
"0382421033",0.192018049935299,304,178,126,189.503432446167
"0382421036",1.95781440365796,2926,2034,892,172.978164116495
"0382521008",0.851455623257548,1694,1127,567,177.632101408275
"0382521021",0.93035414307698,1381,1224,157,187.915857631133
"0382521039",2.83295313818559,2417,2174,243,184.687406523253
"0382521045",0.285366754671505,538,287,251,184.249750591038
"0382521048",1.0277794362487,1603,1339,264,183.985448811164
"0382621001",0.496083416833946,2130,593,1537,164.159169849088
"0382621013",5.14205505081118e-13,58,23,35,196.115410541236
"0382621016",0.158026492456003,724,135,589,177.321582361295
"0382621056",0.23750849206762,1411,232,1179,169.265897477671
"0383221003",0.450606927636493,2427,512,1915,155.124406825699
"0383221006",0.457293693112628,664,520,144,188.582157752955
"0383221012",0.565899517970713,1755,701,1054,170.912692561566
"0383221014",0.395186428485351,1765,431,1334,166.905301632605
"0383221016",0.804338828339416,1748,1057,691,175.77701031386
"0383821003",2.78034891031748,4061,2168,1893,155.937692561566
"0383821006",0.405041315210509,1476,442,1034,171.138436865585
"0383821012",1.46014058087715,2255,1759,496,179.113901534216
"0383821013",1.77991560547417,2633,1954,679,175.908701957255
"0383821014",0.554594657752594,2178,680,1498,164.814617590035
"0391321003",0.969297863674411,2850,1276,1574,163.462489964809
"0391321027",1.11378394018894,3380,1419,1961,152.957708981352
"0391321030",1.13200348760576,1759,1442,317,182.53630718806
"0391321041",1.7718656265055,2930,1949,981,171.912496083821
"0391321045",0.734587796214924,1050,941,109,190.638845842482
"0392021006",1.63964048505878,2415,1887,528,178.478404177611
"0392021014",0.365771064527023,1717,384,1333,166.905995480648
"0392021021",1.08679582806887,2876,1393,1483,164.960110163176
"0392021028",0.755013787846105,2763,971,1792,158.794029247669
"0392421009",1.19851788900789,2327,1506,821,173.805003921153
"0392421012",0.784906093487421,2946,1022,1924,154.83659901427
"0392421030",3.07830133323078,3849,2183,1666,161.745116040927
"0392421031",0.339024829269033,537,351,186,186.620070325896
"0392421045",0.173254000676537,430,154,276,183.714012722557
"0393621007",1.31853051613665,1742,1629,113,190.503881384371
"0393621009",1.17203677698854,2859,1484,1375,166.418692209784
"0393621012",6.18140613554731e-14,4,2,2,233.412151237954
"0393621021",0.488002984114958,650,580,70,193.248220093341
"0393621054",1.46618340859674,2184,1764,420,180.318023150275
"0494321004",0.813434121572479,3260,1075,2185,113.819465920625
"0494321005",5.2727159931148e-13,2213,24,2189,92.3354105412349
"0494321021",0.644692338219905,821,815,6,212.744356512925
"0494321024",4.04053149728372e-13,2206,14,2192,86.2277550952432
"0494321053",0.324066293268967,2476,330,2146,134.913607033974
"0496421001",1.26466689697529,2920,1579,1341,166.816576828343
"0496421005",1.00044938718918,2320,1308,1012,171.454621694832
"0496421007",2.11031884924664,3039,2081,958,172.113760786347
"0496421010",1.506119968459,2323,1801,522,178.623470082233
"0496421039",0.511458456344487,950,622,328,182.314030942492
"0497021010",1.4609744881005,3812,1761,2051,148.032811734258
"0497021015",0.62003606611758,2696,775,1921,154.930126327977
"0497021017",0.250216665630388,342,247,95,191.118780889592
"0497021019",0.565608893262747,2457,699,1758,159.790071279696
"0497021026",0.507517094730182,2685,618,2067,146.967267187445
"0515021009",0.561094496123609,2391,689,1702,161.07686761443
"0515021017",1.50842808173458,3753,1804,1949,153.545405957295
"0515021034",1.00089560112356,2590,1310,1280,167.671018090788
"0515021039",0.402661728782609,2465,440,2025,149.560953732384
"0515021041",0.361698145141178,2277,380,1897,155.792090029556
"0516621005",0.903646319814223,3302,1189,2113,141.656206589147
"0516621007",1.21240769488695,2160,1524,636,176.500682474608
"0516621008",1.39989894363281,3490,1710,1780,159.223913793608
"0516621012",0.883025141843647,1946,1160,786,174.255666251484
"0516621013",1.2121370794676,2755,1523,1232,168.424743998616
"0528621016",0.801811796029159,2442,1046,1396,166.186897789187
"0528621017",0.954132062276289,2227,1249,978,171.946075682134
"0528621034",0.535362699666978,2015,657,1358,166.632626210278
"0528621036",1.52790263678307,3108,1822,1286,167.565031912912
"0528621039",0.219368265630786,1305,216,1089,170.438929913716
"0529721006",0.191330061559951,2355,177,2178,124.332891132023
"0529721017",0.755714809537637,2092,972,1120,169.981456158504
"0529721036",0.526677192593283,2618,645,1973,152.452568998478
"0529721049",0.88020182871621,3182,1156,2026,149.439930560158
"0529721050",0.293181679350827,1860,297,1563,163.659205028401
"1401078501",0.917038835936375,2268,1210,1058,170.873024749254
"1401078601",0.84708661393844,2911,1121,1790,158.850512676921
"1401078602",1.37707233701136,3851,1688,2163,129.241419415666
"1401078603",1.00910685787414,1947,1318,629,176.62353323982
"1401078901",2.32358888862021,3906,2122,1784,159.151052542597
"1437028501",0.714138934824893,2811,905,1906,155.430596310646
"1437028502",1.09745810204058,3157,1403,1754,159.860457920648
"1443011901",0.636295869241705,2810,799,2011,150.412883195043
"1443011902",0.763762012570327,2589,985,1604,162.921659652667
"1443011903",0.730988940828093,1763,933,830,173.725720919125
"1505034901",0.493685212526872,1865,588,1277,167.696701299094
"1505034902",1.15640958259863,3020,1466,1554,163.832120482205
"1507087501",0.572400199019797,2420,711,1709,160.80846491084
"1507087502",0.690341672087653,2491,876,1615,162.711256879464
"1507087503",1.72658198732496,3754,1932,1822,158.09591534595
"1507089301",1.14595336107844,3475,1452,2023,149.70935902455
"1507111601",0.880350288543301,2240,1157,1083,170.536239179537
"1507111602",0.487564526848089,1972,579,1393,166.234275658263
"1507111603",0.665930632364569,2502,842,1660,161.826119831897
"1508134701",1.38627524368876,2957,1698,1259,168.042527217705
"1508134702",1.95320694639293,3807,2030,1777,159.264797610455
"1509008701",0.808263547990104,1522,1064,458,179.872998895947
"1509008702",1.0286654063993,3176,1340,1836,157.598786600235
"1511010701",1.63626264607845,3000,1883,1117,170.020488711326
"1519053501",0.366497365016107,1021,387,634,176.568280585058
"1519053502",1.47255771747069,2561,1771,790,174.198796865432
"1521053801",0.0927298370581942,1103,80,1023,171.314477872402
"1521053802",0.480603506488961,2547,569,1978,152.368962972061
"1521053803",0.0477659173103119,1411,55,1356,166.635907278245
"1521078201",1.68510366984703,3484,1912,1572,163.478415087799
"1521085901",0.450850009574952,2473,513,1960,153.085932201831
"1521117101",0.0618317535973937,1984,62,1922,154.868946804171
"1521117102",0.459162049207477,2405,524,1881,156.478831094226
"1522036401",0.886845449552073,1267,1166,101,190.956816287071
"1522036402",0.965098534709795,1507,1268,239,184.777363955513
"1522037001",0.642054185218796,2340,810,1530,164.261249184848
"1524030001",0.687993862429732,2860,875,1985,152.058573932111
"1529104101",2.89698981084333,2773,2177,596,177.220714373137
"1529104102",1.31922875859588,3002,1630,1372,166.465525510978
"1530114201",0.742633908755675,1426,951,475,179.482048168865
"1530114202",0.0990419118460088,1511,87,1424,165.89544160561
"1530118701",0.752424190254522,2295,965,1330,166.968662485046
"1534072601",0.168227209246668,1133,143,990,171.756179494256
"1540128901",1.2497624204377,2182,1561,621,176.718241703029
"1540128902",0.913944545989928,2701,1204,1497,164.826685954426
"1544083301",0.326041554908403,622,331,291,183.420988761762
"1544091701",1.56984097729113,2018,1851,167,187.540563907308
"1544092201",1.68120835952777,2842,1911,931,172.552811713726
"1544092202",0.996976986947879,1693,1305,388,180.893279278151
"1544092301",1.35644130684943,2622,1665,957,172.126074017802
"1547025801",0.566610366868704,2536,702,1834,157.757811775968
"1547025802",2.01846522630229,3482,2053,1429,165.818882843467
"1549201101",1.97761517778941,3014,2041,973,171.986795543288
"1549201102",0.686662766998081,1769,873,896,172.923885586582
"1549201201",0.81008174774974,1785,1068,717,175.411373985837
"1549201202",0.562148133941212,2452,693,1759,159.735188883871
"1549222201",0.629287802484066,1875,788,1087,170.454327557101
"1549222202",1.14786089675044,2578,1453,1125,169.951832612577
"1549251401",1.91037702372145,2693,2010,683,175.890288761763
"1549251402",0.621646346600221,1913,780,1133,169.769214359249
"1550054101",1.27848828372805,2690,1592,1098,170.287699811089
"1550054102",1.38325396755241,2554,1695,859,173.391980536491
"1550054801",1.41691952282718,2671,1724,947,172.292873611045
"1550054802",2.95392750986079,2571,2179,392,180.857856170374
"1551059401",0.948464856529107,2705,1242,1463,165.292369900114
"1552081601",1.4620489728652,3442,1763,1679,161.494122095096
"1552081602",0.710065178428064,2421,899,1522,164.340511934519
"1552081603",2.17662281216187,4056,2101,1955,153.278296836935
"1552087501",0.67454947617646,2155,854,1301,167.378848341657
"1552087502",0.655886291545737,2183,830,1353,166.646475220505
"1602042701",1.72081461076072,2614,1929,685,175.877355771111
"1602042702",0.216607138499739,716,213,503,178.990900438687
"1602043301",0.639605086934017,1962,802,1160,169.486458439555
"1602043302",1.53630290890201,2637,1825,812,173.92947435512
"1602043901",1.60900806931092,3884,1871,2013,150.360739975087
"1602044801",1.4710709664424,2656,1768,888,173.00226379627
"1602045701",0.445735676634391,2194,501,1693,161.268680116844
"1602045702",0.122821927542581,1973,107,1866,156.76657117152
"1602046701",0.53890407069004,879,660,219,185.380050455718
"1602046702",1.01146946236604,1690,1320,370,181.287458342359
"1602050001",0.782495519754085,3102,1019,2083,145.490618868045
"1603018101",1.03078790549579,1904,1344,560,177.781432579953
"1603018102",1.84431571135361,3168,1987,1181,169.204791093068
"1603074101",0.659090839124619,2305,835,1470,165.107837002558
"1603075501",0.621088062657221,2342,777,1565,163.631740069986
"1603075901",0.146541606411306,338,127,211,185.795131384371
"1603076501",0.587420207943883,2767,733,2034,149.058415622566
"1603077601",0.0259106082055625,268,45,223,185.209340590268
"1603077602",0.547301902325311,1238,667,571,177.560858919692
"1603077603",2.03272756553239,2139,2059,80,192.265275466209
"1604025601",2.04192080315138,3500,2064,1436,165.692601360744
"1604025801",1.52687705504812,2309,1820,489,179.228148215078
"1604025802",0.542263051351045,1150,664,486,179.263257663407
"1604026201",1.04151941782753,3173,1352,1821,158.161242190877
"1604026202",0.411412448514811,902,459,443,180.096438925295
"1604029001",0.67479682825092,2615,855,1760,159.73367634069
"1606037701",0.701179374103288,2761,887,1874,156.666149433539
"1606038501",1.48317201222946,2911,1782,1129,169.891402211933
"1606038602",0.670805331647337,1519,851,668,176.076812774962
"1606040401",1.11503204671442,2389,1422,967,172.032068278112
"1606040701",1.35975092439751,3681,1669,2012,150.384525647603
"1606042301",1.89601477196052,2378,2005,373,181.221902211933
"1608050901",1.41841116934433,2406,1725,681,175.896785109021
"1609007801",1.0944879135264,2221,1398,823,173.786361164799
"1609007802",0.903863881306106,2691,1190,1501,164.781318438154
"1611165201",1.09482944497947,2041,1399,642,176.424364632791
"1611165601",1.46042373192171,2972,1760,1212,168.770435816677
"1611167101",1.34518499470501,3246,1655,1591,163.205600659712
"1611167401",2.29653616993679,3581,2115,1466,165.239511207564
"1612057101",0.341407539427026,2459,353,2106,142.482546900171
"1612057102",0.670797554837991,1693,850,843,173.528627878995
"1612058501",1.40352890873766,3481,1716,1765,159.644857492177
"1612058502",1.1304198624422,2308,1440,868,173.258253669225
"1612059301",1.26009599948451,2922,1576,1346,166.758848330543
"1612059401",0.952096428159802,1374,1246,128,189.422368680423
"1612059601",0.480386724234451,2752,568,2184,115.619680993733
"1612061501",0.618951259883062,1502,773,729,175.140575125188
"1612061502",1.30617577919719,2983,1615,1368,166.558373455734
"1612061901",1.32188032118119,3135,1633,1502,164.76363346217
"1612065701",1.40821592642293,2055,1718,337,182.039451981153
"1612124901",0.66286969819742,2671,840,1831,157.981326754274
"1612125401",0.512557759673322,2240,628,1612,162.766649199141
"1613066701",1.35461571060307,3155,1662,1493,164.86878036947
"1613102601",1.45069357439192,2474,1750,724,175.306419992469
"1613102602",1.057039312662,3326,1361,1965,152.891465239319
"1613155401",0.936241763616581,1624,1230,394,180.816110381846
"1613155402",1.59306996280234,2707,1862,845,173.525339717704
"1613156901",1.51889003139664,2910,1810,1100,170.280630691988
"1613156902",0.684547509201866,2301,866,1435,165.701906143092
"1613157901",0.090371383493195,2034,77,1957,153.210971813129
"1613157902",1.5474667471379,2591,1837,754,174.751029116475
"1613166901",0.740006996507491,2879,947,1932,154.509357886758
"1613167801",1.46200199689028,2402,1762,640,176.438844506088
"1613167802",1.42728939441396,2325,1735,590,177.287266512142
"1613175301",0.929126699281012,3206,1222,1984,152.151206161026
"1613178401",0.416360863709137,2131,466,1665,161.763263069264
"1613183301",0.820132360122804,2650,1083,1567,163.584292764167
"1613183302",0.170273796725547,765,147,618,176.804654051256
"1613190601",0.460121585820857,1093,527,566,177.66893220605
"1614116001",0.408331659566528,717,451,266,183.904321217859
"1614116501",0.853787890196078,2512,1131,1381,166.354606505468
"1614116502",0.958329937632197,2477,1255,1222,168.662429590844
"1616091801",0.448601617869738,823,508,315,182.614342182588
"1616091802",0.803506109497458,2641,1053,1588,163.235351392363
"1616091803",2.82936324455921,2384,2171,213,185.660465201317
"1616092401",0.224247784008324,2128,221,1907,155.406593847134
"1616093501",1.27168335246756,2177,1584,593,177.276319732246
"1616093502",0.159932679575536,654,139,515,178.792459427638
"1617063501",1.38830737168621,3532,1699,1833,157.788114780336
"1617064401",0.662651329083952,2696,839,1857,157.039095089026
"1617064402",0.0706846012988516,2027,68,1959,153.137067239357
"1617066801",0.399327717207189,461,436,25,197.755685641326
"1617068301",0.569568115897186,2130,705,1425,165.869642558114
"1617069701",0.184331635079397,1841,171,1670,161.687845771621
"1617070001",0.43997989165549,2505,498,2007,150.697229228465
"1617071001",0.826554431372631,1943,1091,852,173.462085545267
"1617071002",1.2061958597156,3455,1518,1937,154.233348107884
"1617071801",2.10131786944986,3930,2076,1854,157.18866293339
"1617072101",1.37335045665324,3509,1684,1825,158.041961000009
"1618061701",1.52078257046103,2584,1811,773,174.454572676976
"1619044601",2.15146687761227,2522,2092,430,180.190565941756
"1620086301",0.502466480851686,1538,610,928,172.578780253393
"1620088001",1.5837683079905,1975,1858,117,190.164285607884
"1620100301",0.63912257679104,1112,801,311,182.717607599912
"1623040701",2.78190926703837,2246,2169,77,192.370524308099
"1623040702",1.46924755995308,1898,1766,132,189.354248598695
"1623048701",0.350137178762289,1568,363,1205,168.877398248258
"1623050201",0.337994237872892,409,347,62,193.638953545454
"1623050202",0.960921580237818,1518,1263,255,184.197175042322
"1624055301",1.03324094441467,1997,1347,650,176.359203289948
"1625061001",2.40320153436249,3618,2133,1485,164.953563278747
"1626037801",0.107502207697424,1895,99,1796,158.709034101506
"1626038101",1.07337542338267,1918,1378,540,178.217168262193
"1626038102",0.474385883929911,1123,553,570,177.564597409427
"1626038301",2.15210566686989,2347,2093,254,184.200935516057
"1626039701",1.23225460452398,2736,1544,1192,169.035661995128
"1628036101",0.708799438452334,1169,898,271,183.78461693331
"9002561001",1.70751812933859,3247,1920,1327,167.031816552884
"9002561002",0.596686431772606,2257,741,1516,164.458659381311
"9002561005",1.54623940160015,3643,1834,1809,158.410341138517
"9002561006",1.18377140022428,3120,1491,1629,162.476560706825
"9002561007",0.775291383045561,1841,1006,835,173.613530955623
"9003461001",0.793904171433469,2338,1036,1302,167.374908999034
"9003461005",0.431495186619485,775,486,289,183.533114572349
"9003461016",0.748900871201875,1240,962,278,183.699841289118
"9003461023",0.608596012617413,815,757,58,193.843831447691
"9003461046",0.929677784644073,1314,1223,91,191.431604444582
"9004621006",1.55940710363263,2608,1842,766,174.611002967221
"9004621008",0.279369618014293,2413,278,2135,137.515313330018
"9004621010",0.173964250674394,1234,156,1078,170.625259799602
"9004621014",0.479649465574425,1336,567,769,174.538978383672
"9004621034",1.45413033797977,2178,1753,425,180.280077082391
"9007261006",0.523615170396495,665,641,24,197.995398615193
"9007261017",0.169205314551303,2188,145,2043,148.622689846259
"9007261046",0.452167653380222,2646,514,2132,137.557114833998
"9007261047",0.17383112747968,2022,155,1867,156.745447556258
"9007261074",0.213273522110537,1976,205,1771,159.449763758616
"9007761024",0.258509201261185,1883,259,1624,162.574380751032
"9007761052",0.872959838423391,3170,1150,2020,149.849915726002
"9007761054",1.11286064698318,2743,1417,1326,167.03236788154
"9007761063",0.777032019275509,2836,1009,1827,158.018216486363
"9007761073",0.772258497423192,2613,1000,1613,162.761250852398
"9008361002",0.899444632238649,2656,1181,1475,165.064784752993
"9008361022",0.593615303560751,2831,740,2091,144.305105624808
"9008361029",0.818457344438788,1935,1081,854,173.438293419117
"9008361040",1.11635713675986,1712,1429,283,183.681944389926
"9100421002",0.370607899824095,1616,390,1226,168.577481043032
"9100421003",0.844788039040662,2925,1118,1807,158.473721025331
"9100421007",0.829950596259484,2930,1098,1832,157.920410171141
"9100421041",0.398832524566102,1451,435,1016,171.378434973651
"9100421046",0.932388689647566,2161,1225,936,172.488261911928
"9101821017",1.99081034454594,3983,2044,1939,154.169833382656
"9101821020",1.4069325715593,2292,1717,575,177.510293669013
"9101821036",0.79226600289773,1260,1034,226,185.161113160577
"9101821037",1.79774062464208,3056,1964,1092,170.369902082437
"9101821038",1.18536918893228,1945,1496,449,179.988339819506
"9104221001",1.54019315252939,2735,1828,907,172.825405793851
"9104221004",0.686065748141689,1206,870,336,182.069263307483
"9104221010",0.678873072431308,2071,860,1211,168.770599755572
"9104221024",1.5626738587963,3378,1845,1533,164.215230553914
"9104221030",0.431673510811671,651,487,164,187.715604726328
"9104721005",0.729852121772676,1137,929,208,185.875257303595
"9104721019",2.02941725195202,3220,2057,1163,169.478570425898
"9104721048",0.971367220638072,1859,1278,581,177.417858717751
"9104721054",0.666539450007117,1378,843,535,178.355758345984
"9105621001",0.778535590274861,2531,1014,1517,164.431305286171
"9105621003",0.106178185127176,994,97,897,172.909500637434
"9105621016",1.0711853308008,2557,1375,1182,169.200643674814
"9105621017",0.994626270839182,2272,1303,969,172.016065496418
"9105621024",1.34014606783111,2210,1651,559,177.787468094305
"9106121003",0.531507565039078,1583,654,929,172.572993429244
"9106121011",0.477052501744762,988,559,429,180.19539731933
"9106121014",1.20324413654545,2767,1515,1252,168.119037283926
"9106121022",1.1892673695282,3292,1498,1794,158.749326936525
"9106121027",0.803705762172662,2645,1055,1590,163.228292529268
"9106521024",0.643072270491922,970,811,159,187.873080165558
"9106521033",0.844694138572151,2522,1117,1405,166.124668192991
"9106521034",0.170799866666809,1627,149,1478,165.019614083288
"9106521042",0.691796957940985,2149,879,1270,167.917764322981
"9106521055",1.76776115444662,3391,1946,1445,165.481108274435
"9106921002",0.852191442411295,3057,1128,1929,154.638350122453
"9106921019",0.331856222174722,1494,336,1158,169.548280927141
"9106921023",0.71831278127686,2405,913,1492,164.87850480472
"9106921049",0.483332574971234,1532,572,960,172.111479866949
"9106921059",1.27808178201553,3649,1590,2059,147.498551708175
"9107121003",0.809564130354247,1565,1066,499,179.060307695042
"9107121009",1.33862433781551,3156,1648,1508,164.688000397541
"9107121086",0.133304573360799,251,113,138,189.041841922639
"9107121093",1.48021530228988,1928,1778,150,188.319147709699
"9107221008",0.350428674857794,2509,364,2145,134.990131694218
"9107221015",0.242006281304139,2422,242,2180,119.086280889592
"9107221044",0.35630097007594,2528,372,2156,130.401280889591
"9107221045",0.6238692500787,2820,782,2038,148.939140463236
"9107221048",0.0661353793360619,2125,65,2060,147.471918285535
"9107821018",1.41507813974583,1782,1723,59,193.733537603078
"9107821052",1.83389362705626,4013,1984,2029,149.327829746192
"9107821065",1.47218707200175,2687,1770,917,172.664924749842
"9107821070",0.406268536184431,1153,446,707,175.532150840287
"9107821072",0.285005849966758,521,286,235,184.910130695475
"9107921008",0.662044726832514,1793,837,956,172.133495168881
"9107921009",0.0851192660908465,615,73,542,178.174300294117
"9107921011",1.27341119133862,2953,1587,1366,166.571152837492
"9107921019",0.395585747902463,446,434,12,201.800922242142
"9107921022",0.47818371517692,1844,561,1283,167.63014871555
"9108221005",0.465286179905696,2079,534,1545,164.008833331433
"9108221030",0.589934164364622,1345,736,609,176.958431680731
"9108221035",0.965548913167408,2607,1270,1337,166.881645827483
"9108221042",0.823310347454356,3105,1088,2017,149.935906303349
"9108221046",1.58369251760668,3351,1857,1494,164.864286798452
"9108621017",0.855411872163707,1985,1134,851,173.47320722928
"9108621034",0.902790568714373,1854,1185,669,176.067439813968
"9108621035",0.686031243929431,2200,869,1331,166.951379566743
"9108621046",1.49423815937506,2166,1790,376,181.201920744544
"9108621048",0.6158318609111,920,764,156,187.918988234534
"9108821020",0.54737696446679,1842,668,1174,169.376394500358
"9108821022",2.10490914048905,4021,2079,1942,154.091982025423
"9108821023",1.05913302596317,3010,1363,1647,162.249747662814
"9108821027",0.902950745374649,1751,1186,565,177.693215221136
"9108821078",1.36778180096906,2049,1675,374,181.218805804557
"9109421010",1.25440005511221,2647,1568,1079,170.624527217704
"9109421013",1.31697276011669,3599,1627,1972,152.462404659959
"9109421017",0.0987855921624438,1415,86,1329,166.978647709699
"9109421019",1.78091265451945,2228,1956,272,183.743273930397
"9109421046",1.91527320137139,3605,2013,1592,163.159270299526
"9109921005",0.937677939587625,3108,1231,1877,156.644161341067
"9109921007",0.360880452498893,1116,379,737,175.038459454605
"9109921008",1.9862550707084,3182,2042,1140,169.716268460976
"9109921010",0.785400081557088,2640,1023,1617,162.685742962344
"9109921026",1.37324476174772,3841,1683,2158,130.219539008222
"9110021004",0.735442740401677,1310,942,368,181.375370902094
"9110021014",0.409834011380053,1417,453,964,172.053149268115
"9110021023",1.33185335883326,3488,1639,1849,157.2938845093
"9110021025",1.38979024675115,2739,1700,1039,171.058678930356
"9110021065",1.65321469322782,3028,1894,1134,169.753088189315
"9110121003",0.826254765657228,3007,1090,1917,155.037124893339
"9110121007",1.43042076064572,2412,1738,674,175.987428672629
"9110121010",1.00492561183732,2669,1317,1352,166.659662016277
"9110121043",0.484188308982928,971,573,398,180.715145566837
"9110121046",2.0933746027518,3298,2075,1223,168.646489833998
"9110821008",0.984676628064116,2357,1296,1061,170.861780465498
"9110821017",0.950204129200669,2871,1244,1627,162.529107026917
"9110821045",0.579094597354723,2087,717,1370,166.476140178046
"9110821048",0.478612711055121,783,562,221,185.250379033361
"9110821051",0.388957724076942,1335,423,912,172.723616494794
"9111121002",1.96453210728872,3164,2038,1126,169.949147709699
"9111121007",0.373146620665262,2205,392,1813,158.328911047918
"9111121016",1.17127122854407,3321,1482,1839,157.523990366533
"9111121026",1.71552330174475,3845,1926,1919,154.991067381118
"9111121036",0.157001560555396,1909,134,1775,159.343671596427
"9111221005",0.557765854572734,1480,685,795,174.130798674942
"9111221014",2.63216227681733,3939,2156,1783,159.191454949238
"9111221024",0.289627150137656,1236,294,942,172.389251108125
"9111221039",0.909155005296124,1816,1200,616,176.825132431041
"9111221053",1.31560390446416,2534,1626,908,172.784193134449
"9111321006",1.60122238622221,3014,1868,1146,169.697740224395
"9111321012",1.67787779881539,2924,1909,1015,171.403536489052
"9111321016",0.426889242221775,1427,481,946,172.321099509023
"9111421013",0.937970909749246,2916,1232,1684,161.372144384325
"9111421022",0.200135817021035,1247,184,1063,170.798567328165
"9111421024",1.13185389348095,3269,1441,1828,158.011968214033
"9111421026",0.733599193799563,2141,938,1203,168.891032949377
"9111421045",0.136580664090242,1159,118,1041,171.033075651276
"9111721020",2.49907041804386,3186,2142,1044,171.023052183878
"9111721021",0.67269881466871,2125,852,1273,167.746024515323
"9111721024",2.18826737927876,2198,2105,93,191.300742886247
"9111721040",0.66658104554253,2797,844,1953,153.391702771617
"9111721041",0.285456765751339,1639,289,1350,166.695693233496
"9999901001",0.0764374009803885,673,71,602,177.132315040737
