"","ASV","YSI","rASV","rYSI","means"
"0005441006",0.860816814889339,596,526,70,257.632740304476
"0005441018",0.943967574215422,855,600,255,253.318466788043
"0005441020",0.926267968481378,1317,588,729,246.90221823107
"0005441029",0.731858734401893,501,409,92,256.786995140182
"0005441030",1.3351282359573,1491,957,534,249.590546178386
"0005841003",0.84765881956884,1115,514,601,248.668749526128
"0005841016",0.496747616395069,432,221,211,254.009253143662
"0005841023",2.17083041668633,1673,1353,320,252.277091547547
"0005841038",1.55195113369117,2612,1103,1509,224.019079049478
"0011021002",2.16613643012277,1809,1352,457,250.419023501383
"0011021021",2.06727622808035,1659,1321,338,251.909273770239
"0011021044",1.60622166417363,1276,1141,135,255.571460016835
"0011021048",1.68356921686589,2272,1181,1091,241.768907384861
"0012521012",0.977622366782772,987,632,355,251.583399307686
"0012521013",0.691731894993041,1420,374,1046,242.446992341196
"0012521028",1.00242450129148,1495,656,839,245.456736609284
"0012521040",0.106151179020485,795,12,783,246.207794861937
"0012521047",1.4058475619075,1287,1015,272,253.099465104517
"0013921059",0.347354058252755,1656,114,1542,218.230773205367
"0013921061",1.0632164274131,2275,711,1564,212.70571621149
"0013921065",1.23040915320546,1945,867,1078,241.979308037735
"0013921090",0.956686606615352,789,609,180,254.577334052008
"0015621007",1.84249985296196,2822,1244,1578,207.195969112417
"0015621013",1.57535191357024,2719,1122,1597,181.445602767386
"0015721003",1.32534771770884,2124,953,1171,240.468226341675
"0015721012",1.47051227876687,2360,1050,1310,237.318158126012
"0015721032",1.33688930057747,2100,958,1142,240.781325674594
"0015721034",0.531968316961087,962,253,709,247.134860687382
"0015721058",1.07281282510109,1976,714,1262,238.533215110141
"0016321020",1.62375605695607,2103,1153,950,243.808122151221
"0016321021",0.170786301896569,1156,30,1126,241.07768776775
"0016321028",1.47814265618533,2450,1056,1394,234.554234596071
"0016321032",1.70445068310395,1490,1199,291,252.805066735941
"0017121001",0.609407962758554,1331,315,1016,242.872254393736
"0017121002",0.175503842595084,1111,35,1076,242.002517778862
"0017121015",0.785847573763473,1738,454,1284,238.125328214561
"0017121025",0.752363672478582,1863,425,1438,232.241070044628
"0017121040",0.717672014700127,958,402,556,249.248914739782
"0018921002",0.446050966188506,821,183,638,248.20576650201
"0018921005",1.65568809699605,2172,1169,1003,243.074412755662
"0018921008",0.73610762722766,1978,412,1566,211.884168469012
"0018921012",0.332904107033215,151,106,45,258.786605215979
"0018921020",0.626012880526386,1478,328,1150,240.686733763357
"0019121010",0.795519459893917,1834,463,1371,235.5659343606
"0019121055",1.20702146707926,2076,843,1233,239.152841106626
"0019121056",1.33885108408146,2431,960,1471,228.770732495252
"0019121066",1.26407565010866,2006,896,1110,241.372189811936
"0019121067",1.19486646033326,2104,836,1268,238.491701115453
"0021921022",1.15220761136414,2318,802,1516,223.453015980425
"0021921031",3.19230016065781,2009,1563,446,250.521128805042
"0021921044",0.37241555094438,157,130,27,259.778414018285
"0021921046",1.77581339492116,2778,1228,1550,217.28125408707
"0023921002",0.812116260136841,1612,480,1132,240.984407155459
"0023921031",0.957157060301148,909,610,299,252.729278275942
"0023921033",0.351065947475281,1079,118,961,243.688151953188
"0023921041",0.509766197483091,1220,233,987,243.251417766082
"0025621014",0.529141055376225,960,250,710,247.108343531672
"0025621025",1.60578968992743,2445,1140,1305,237.498394658016
"0025621031",0.905675106295842,618,569,49,258.62594494261
"0025621049",0.653027744322377,1052,348,704,247.271744545786
"0025621064",0.637494531964244,820,338,482,250.136548999048
"0028421003",0.239309688139238,819,60,759,246.536757027116
"0028421008",2.78249864996406,1630,1496,134,255.587284731426
"0028421019",0.742244316596239,1568,417,1151,240.683785366877
"0028421026",0.729367078145206,786,408,378,251.257642695092
"0028421027",1.99390260199085,1320,1297,23,260.06559407565
"0030221007",1.27782226606666,2461,907,1554,215.408796233286
"0030221020",2.65653055996226,2950,1472,1478,227.815968190968
"0030221034",0.776923159341851,1844,445,1399,234.416274969066
"0030221035",1.98554297033945,2209,1295,914,244.304412006989
"0030221036",1.32187267775877,2185,950,1235,239.105228011393
"0034441004",2.50464716063042,1438,1437,1,265.605092261905
"0034441008",2.92612152775137,1580,1525,55,258.443367836448
"0034441036",1.30670178777385,994,935,59,258.218606114778
"0034441069",5.05001471341159,1668,1603,65,257.88260726701
"0034441076",2.64558551991599,1708,1468,240,253.481092259161
"0035541003",0.826847247746348,1606,490,1116,241.219439210688
"0035541007",1.19314258352095,2185,833,1352,236.262943341173
"0035541010",2.09900013449923,2809,1332,1477,227.855873867393
"0035541015",0.792596019160728,1545,460,1085,241.891774830286
"0035541018",1.10369001650872,2281,753,1528,220.756809576435
"0040041022",1.44615508650875,1689,1036,653,248.022914078413
"0040041041",0.2000559710936,1346,46,1300,237.739212358833
"0040041063",1.01324318312748,701,666,35,259.273423388995
"0040841015",0.959423080623704,876,614,262,253.273992007003
"0040841034",2.41481686674061,1766,1414,352,251.70829604828
"0040841041",3.36606175427609,1715,1570,145,255.391961238613
"0040841069",1.89410150289778,1606,1262,344,251.811216756331
"0040841072",2.20859852554872,1845,1362,483,250.129011431277
"0047141014",1.31633982449421,1670,944,726,246.939595295344
"0047141018",1.32087811650417,2208,948,1260,238.628848822682
"0047141065",0.857591756541373,1453,523,930,244.057496309451
"0047141069",1.06144095710491,1327,710,617,248.51051284385
"0047141075",0.892879591529216,1656,560,1096,241.666902173649
"0049641007",1.12217168042306,1465,772,693,247.462720956727
"0049641034",0.778499252033062,1741,447,1294,237.864488553315
"0049641035",1.93161941509526,1968,1274,694,247.416572668276
"0049641047",0.688318948006801,934,371,563,249.167202637858
"0049641048",1.01683133868973,1914,671,1243,238.969907304321
"0056641013",2.10216730578697,1988,1334,654,248.004769237142
"0056641016",0.856881792984992,959,522,437,250.682217068631
"0056641019",1.70159498835608,2533,1198,1335,236.671285991992
"0056641020",1.48770390349534,1746,1064,682,247.615546574002
"0056641039",1.54006335183733,1935,1097,838,245.497994104868
"0060941019",1.11766514709527,2020,768,1252,238.711152654648
"0060941020",0.109927169319253,442,14,428,250.777495868533
"0060941028",1.66703746089512,2145,1175,970,243.58697823185
"0060941033",0.663278456889088,462,356,106,256.296466327088
"0060941056",1.1476865179622,1639,798,841,245.445802907174
"0063921003",1.58240646237358,2423,1127,1296,237.838366439321
"0063921005",0.951568587317674,1267,607,660,247.887395559893
"0063921025",1.01472890582325,2232,669,1563,212.798251391445
"0063921033",0.157220187341319,907,25,882,244.861474897799
"0065221010",3.09328032892409,3107,1551,1556,214.585054800519
"0065221014",1.45627629110486,1049,1042,7,262.169696037179
"0065221015",1.87309737454854,1494,1256,238,253.534074712767
"0065221016",1.13131919516448,879,782,97,256.636183878963
"0067921010",1.00777280454535,1558,661,897,244.59772856976
"0067921011",0.484546772079963,952,210,742,246.700061202577
"0067921017",1.55164882070906,2567,1102,1465,229.82732425157
"0067921021",1.81252283782181,1627,1239,388,251.197514827969
"0067921023",0.743038845386831,1512,419,1093,241.742201038613
"0071621001",0.223453565493133,88,55,33,259.327325373906
"0071621011",1.12829311571414,1814,780,1034,242.576729995517
"0071621013",0.706989556287883,949,389,560,249.196955301774
"0071621022",0.455087322524928,446,186,260,253.286484184232
"0071621030",0.405047781222564,443,162,281,253.016029157776
"0071721012",1.18709687817161,1762,827,935,243.964461036083
"0071721013",0.796067231988968,1516,464,1052,242.343833721941
"0071721015",1.71206303459314,2168,1201,967,243.608616459364
"0071721070",1.55243218448251,2249,1105,1144,240.769676885049
"0071721075",1.08245880533836,1638,725,913,244.334722099094
"0071921010",1.16287982911906,2098,809,1289,237.998129245959
"0071921018",1.4817788260815,2282,1058,1224,239.349285691364
"0071921021",0.272424299368925,1524,81,1443,231.831731979649
"0071921023",0.108546685322997,1401,13,1388,234.717288637492
"0071921032",1.57952262649459,1973,1125,848,245.301695824441
"0072021001",1.35883575555723,986,980,6,262.322603672766
"0072021007",0.882979639665281,1025,550,475,250.230707729205
"0072021008",1.71819462923606,2144,1203,941,243.909982545076
"0072021009",0.288379320253979,1439,85,1354,236.18372416411
"0072021015",3.27019818149476,1973,1565,408,250.997576622388
"0072321016",1.49947274217558,2564,1072,1492,226.455651512267
"0072321017",0.267775277214311,643,78,565,249.142934140138
"0072321036",0.675558872647436,1926,364,1562,213.521401675367
"0072521006",1.19856142826911,1368,839,529,249.614911049739
"0072521007",1.47215781001546,1061,1051,10,261.4652129329
"0072521010",2.9889311761791,1710,1534,176,254.61782051918
"0072521011",1.28600390895965,1012,912,100,256.46815652114
"0072521016",1.09198027091479,824,739,85,256.994428593575
"0074321005",2.03996949866804,2909,1313,1596,184.241136873503
"0076021006",0.705968028589114,1748,386,1362,235.913066415271
"0076021008",2.34419276778168,2536,1395,1141,240.787666503453
"0076021012",0.270632368533946,545,79,466,250.303911212451
"0076021013",0.520030774174179,1479,242,1237,239.0969061419
"0080621001",1.75966541077935,2271,1221,1050,242.379412274659
"0080621004",1.50809627539785,2022,1078,944,243.881696842572
"0080621011",1.21819288452347,2127,855,1272,238.332644016682
"0080621012",1.39274222702447,1438,1004,434,250.702663857953
"0080621026",1.19434357739454,1417,835,582,248.96160808194
"0083321003",1.02962836805651,1084,682,402,251.048694053632
"0083321004",1.10110705787255,1082,749,333,251.942668568122
"0083321009",0.212089805627738,909,52,857,245.192577523749
"0083321019",1.62344913627086,1536,1151,385,251.208971279196
"0083321020",1.55505581296679,1510,1107,403,251.043213668854
"0087141021",0.869260890428453,1309,535,774,246.339784729364
"0087141023",1.11383293821557,1883,763,1120,241.157105436436
"0087141025",1.00468683973173,934,658,276,253.070359936354
"0087141054",1.39821327180991,1927,1008,919,244.259988132441
"0087141059",0.569414645150153,1701,287,1414,233.809527814981
"0087841013",0.740974514061501,1583,415,1168,240.504949131321
"0087841015",1.01386813639582,1628,668,960,243.698524340238
"0087841019",0.556524869590845,1418,279,1139,240.801463902045
"0087841069",2.07002809914638,1997,1322,675,247.705429470428
"0096241014",1.97544412783515,1733,1291,442,250.605826713745
"0096241015",2.99993989188591,1613,1538,75,257.297176853175
"0096241016",0.706011887487552,645,387,258,253.296134516225
"0096241026",1.57331657633657,1425,1121,304,252.677626212527
"0096241031",2.27454827914757,1657,1377,280,253.027611050986
"0100941005",0.702430214638987,669,382,287,252.915064300707
"0100941006",0.576159345440936,1107,289,818,245.803539739784
"0100941023",0.749885569343711,642,422,220,253.808693760147
"0100941031",1.73558315346939,2694,1211,1483,227.155216547545
"0100941032",0.93712140359238,2121,596,1525,221.819429510514
"0105341004",0.506218168008543,1134,229,905,244.433832559169
"0105341009",1.53081906434726,1612,1092,520,249.70542702782
"0105341011",2.51341175297074,1542,1439,103,256.430797461219
"0105341017",0.935811721119588,1646,595,1051,242.3658245782
"0105341026",2.94607442979887,2192,1528,664,247.840209317435
"0117571014",0.797808321102124,1498,465,1033,242.602582508748
"0117571034",1.42529492854457,1550,1025,525,249.643617341201
"0117571036",0.602576816098252,934,309,625,248.442922014921
"0117571042",2.09364976856225,2818,1329,1489,226.6296983497
"0117571044",0.741278432373513,1469,416,1053,242.339551644548
"0119541001",1.98061980672429,2011,1292,719,247.021006811438
"0119541006",1.32108265699985,1498,949,549,249.304900920706
"0119541012",1.56202731177206,1494,1111,383,251.216352582296
"0119541017",0.551563900900922,851,273,578,249.015268807567
"0119541018",1.7773634603914,2158,1230,928,244.094563692581
"0121641053",3.37478600721809,1812,1571,241,253.476147507695
"0121641068",2.70471514908411,1974,1483,491,250.104417735043
"0121641078",2.62033605090057,2191,1464,727,246.918491627051
"0121641081",1.02070087830638,1139,675,464,250.351684960604
"0121641087",2.99026994040026,1870,1535,335,251.930452020202
"0123221003",2.41574346487838,1638,1415,223,253.746991077824
"0123221006",0.855276398127422,1802,519,1283,238.127471137093
"0123221007",1.14480304567543,1305,794,511,249.810074792698
"0123221021",0.891610539467044,830,559,271,253.104336036083
"0123221023",0.444229983901587,1721,182,1539,218.793510462686
"0124021006",0.609025869080542,919,313,606,248.628148846728
"0124021010",0.943994892690358,895,601,294,252.775907275574
"0124021014",0.401567267460693,898,157,741,246.705076456158
"0124021018",0.100308696951174,1214,11,1203,239.730151512274
"0124021025",1.38099481864928,1534,993,541,249.450865357072
"0124121005",1.0151213907631,780,670,110,256.148556715096
"0124121016",0.880801273904159,2118,549,1569,210.680760934788
"0124121036",1.04110904719755,920,690,230,253.668000277707
"0124121085",1.11668921832008,927,766,161,254.904595295342
"0126921008",2.0181918274603,1519,1305,214,253.98959264984
"0126921010",0.0378870019714319,1361,3,1358,236.145883214212
"0126921013",0.943529935806668,774,599,175,254.621964783879
"0126921016",1.68540884975719,2137,1182,955,243.711709713333
"0126921023",1.70133437641354,2271,1197,1074,242.046114475238
"0127321001",1.02606491456605,2055,678,1377,235.231837358833
"0127321005",0.923370553684494,2033,585,1448,231.263923999043
"0127321012",1.34468959373054,1545,965,580,249.000673437881
"0127321018",1.517541181454,1235,1083,152,255.208494104866
"0127321022",0.626770075476929,1563,329,1234,239.134520559892
"0129921001",1.0473625928709,1068,698,370,251.356590831771
"0129921006",1.54187022740025,1212,1098,114,256.04764811057
"0129921009",0.990590771189992,1235,645,590,248.79814729925
"0129921025",0.844943314644442,810,509,301,252.687235141595
"0129921033",1.48416279777106,1266,1060,206,254.08370583412
"0130821002",0.491496373160276,805,216,589,248.813248073122
"0130821011",1.56569858515005,2571,1114,1457,230.325336251582
"0130821014",0.40286547597836,1268,159,1109,241.388632111922
"0130821019",1.77604282168763,2743,1229,1514,223.601132281656
"0130821021",0.899859097568848,2057,563,1494,226.212352190719
"0132021009",0.446772945854256,1245,184,1061,242.222760198341
"0132021010",1.33477274392985,1036,956,80,257.238498514039
"0132021015",2.59162495667969,2656,1458,1198,239.91523286148
"0132021024",1.14725061543969,1814,797,1017,242.864183037846
"0132021034",0.716520993798839,1490,401,1089,241.783431935555
"0133021001",1.63865770782577,2433,1159,1274,238.283279732246
"0133021008",0.428011928570706,1634,172,1462,229.93564622127
"0133021016",1.96823301901192,2234,1288,946,243.875989475234
"0133021020",1.15206661042168,2234,801,1433,232.610817517565
"0133021028",0.495287585461735,1745,219,1526,221.120997355668
"0138521001",0.518736715588115,854,241,613,248.553790842079
"0138521005",0.558368125396233,1784,281,1503,224.968415141482
"0138521016",1.0202954805109,2245,674,1571,209.963882037332
"0138521033",1.75793937615875,2714,1219,1495,226.133618455223
"0138521038",0.43644709481064,1701,177,1524,221.911566856187
"0139321008",0.232155395678089,254,58,196,254.356449011071
"0139321015",1.1182771671404,870,769,101,256.461890930263
"0139321020",1.9647728353609,2079,1284,795,246.014181715096
"0139321029",0.76578582642606,1044,434,610,248.613521221267
"0139321035",0.638528160049412,873,340,533,249.593997411746
"0140871007",0.675582169585636,1152,365,787,246.114973381763
"0140871028",1.209238638925,1354,844,510,249.81117596313
"0140871030",0.376938342118922,598,135,463,250.377803227844
"0140871037",0.529954485107719,1404,251,1153,240.63315680328
"0140871039",1.08788923592172,1286,733,553,249.281686765602
"0141171032",0.425716791137081,1448,170,1278,238.196890736016
"0141171052",0.390875685555634,1527,147,1380,235.114866900278
"0141171064",0.361350122112676,836,122,714,247.08567476746
"0141171067",1.17800128942982,1544,820,724,246.962873734496
"0141171097",0.924723507802371,1464,587,877,244.900120868534
"0146271015",0.846203328862525,890,511,379,251.245587298711
"0146271035",0.961112351993898,1847,616,1231,239.245257552841
"0146271051",1.04134868136763,2058,691,1367,235.734191635731
"0146271055",1.50727597162969,2549,1077,1472,228.559271435156
"0146271058",0.370781285435174,1069,127,942,243.90630451051
"0147071016",1.54946103175773,1403,1101,302,252.682628364126
"0147071028",1.21665652782795,1751,853,898,244.558642693931
"0147071050",0.383948186978216,428,140,288,252.912940492804
"0147071055",1.63981534396577,1868,1160,708,247.17345221774
"0147071103",1.11972250399401,969,771,198,254.33141606254
"0150171011",0.630593017453611,1071,333,738,246.750831967623
"0150171020",0.699667363176507,779,380,399,251.077387182467
"0150171021",0.506058893622479,302,228,74,257.547090665713
"0150171023",0.978906680067262,929,634,295,252.770635859719
"0150171024",1.78959083158509,1458,1233,225,253.728199131323
"0150971023",0.794579675279021,1433,462,971,243.576094654008
"0150971047",1.5191036537717,1588,1084,504,249.895685903807
"0150971075",0.259695475626322,428,72,356,251.57871610663
"0150971077",0.57124334172019,1507,288,1219,239.447300101337
"0150971080",0.833336797674699,667,499,168,254.811644016683
"0152721029",1.04433008861287,1958,693,1265,238.503830083701
"0152721038",1.64558354306125,2483,1165,1318,237.182339956335
"0152721046",0.470846682331945,1457,201,1256,238.657865256863
"0152721052",1.76811157110452,2471,1226,1245,238.942995991641
"0152721071",0.533216144016942,1204,256,948,243.851727214351
"0153021004",2.0440796164111,2761,1314,1447,231.446531161944
"0153021012",0.385935453706441,1444,143,1301,237.634303448302
"0153021020",0.622907616743671,1805,325,1480,227.415471618096
"0153021037",0.152279103777562,930,23,907,244.417796333501
"0153021050",0.149812453239861,805,21,784,246.186697287487
"0154021006",3.03071280521627,1807,1541,266,253.174405260069
"0154021016",0.7527335490337,807,426,381,251.231636300634
"0154021021",0.959559081962464,631,615,16,260.788097940845
"0154021033",1.11926541580685,811,770,41,258.933855877353
"0154021074",1.5764282678523,1914,1123,791,246.063182131054
"0160221013",1.00077922725073,1045,655,390,251.190043308728
"0160221016",1.43920496964897,1169,1032,137,255.558791308902
"0160221020",0.433145609154929,482,175,307,252.641524247565
"0160221031",1.13901991443174,1526,786,740,246.717277835024
"0160221051",0.630505964966819,770,332,438,250.65181641527
"0160821001",1.60945051374757,1806,1143,663,247.850747795402
"0160821007",0.991510195465855,1353,647,706,247.24783385881
"0160821012",1.35217881068145,1112,974,138,255.529738407164
"0160821015",2.7563217132919,1535,1489,46,258.689775449587
"0160821018",2.5341307090468,2092,1447,645,248.097020116764
"0162821017",0.686693384502557,437,370,67,257.771675421962
"0162821019",1.30547990774012,1801,933,868,245.022690096957
"0162821021",0.6562361799812,823,350,473,250.23859735555
"0162821023",1.18664702402957,2246,825,1421,233.433585103704
"0162821043",1.09953205066692,909,747,162,254.889842269519
"0164121059",1.11379260815476,1203,762,441,250.614875561751
"0164121062",0.696600825942372,1971,379,1592,199.709716765237
"0165621001",0.468692536802316,1399,200,1199,239.823185743476
"0165621011",0.249396816035823,1036,64,972,243.528925321798
"0165621020",1.25658458734482,2103,892,1211,239.623318399398
"0165621062",0.832161680036787,1838,497,1341,236.555853659887
"0165621068",1.76940967324271,2437,1227,1210,239.6355720069
"0166221006",0.540326746218608,321,265,56,258.355236168357
"0166221008",1.60290230224074,1681,1138,543,249.433037755662
"0166221029",1.14010729176368,1453,787,666,247.812056715097
"0166221038",0.552156276574017,1216,276,940,243.918434100057
"0166221043",0.721712942815102,897,405,492,250.056981538728
"0169241011",0.278955495126157,272,83,189,254.450421353545
"0169241055",2.97707431625052,2666,1530,1136,240.905300690558
"0169241056",1.85899036531125,2642,1252,1390,234.66218269855
"0169241057",1.42465444799683,2369,1023,1346,236.479377371888
"0171441005",0.872562391334584,1090,539,551,249.291366536878
"0171441008",1.50599194401942,1474,1076,398,251.079736799516
"0171441009",1.96175800867081,1395,1283,112,256.097845706869
"0171441029",1.37447148386567,1237,988,249,253.432417989418
"0171441033",0.40802921345554,1237,166,1071,242.06115909842
"0173841005",0.913491544440207,1065,577,488,250.110690092519
"0173841014",0.536771435824326,731,261,470,250.267752702751
"0173841022",0.551560740616008,962,272,690,247.502636300632
"0173841026",0.63821701200351,1497,339,1158,240.586923518049
"0176641096",1.34573155699545,2392,967,1425,233.057194501691
"0176641097",2.71039306665128,3042,1485,1557,214.504954484042
"0176641109",1.94275982803559,2781,1276,1505,224.375075674537
"0176641149",4.00464388375349,3152,1593,1559,214.308311565182
"0176641157",0.87993402231926,2100,547,1553,216.191755348249
"0178821001",0.920278328722297,1904,580,1324,237.007711799207
"0178821002",0.770716581110172,1525,438,1087,241.849169148959
"0178821003",0.763245579248352,1731,433,1298,237.765272323563
"0178821005",1.25593076427109,2344,891,1453,230.761908676134
"0178821009",0.588959292129261,1668,298,1370,235.648537535199
"0179021026",1.66463047973266,2256,1174,1082,241.943077838975
"0179021028",0.473160103815165,1094,203,891,244.662772544021
"0179021042",0.599330449358387,1081,306,775,246.336057596926
"0179021064",0.981973498778757,1918,638,1280,238.151829402285
"0179021073",1.04423066284942,1103,692,411,250.979764988304
"0179821006",1.39642057921967,1916,1005,911,244.373732841436
"0179821009",0.901750274768221,1027,565,462,250.382537009492
"0179821010",2.15815239900885,2142,1349,793,246.050604240101
"0179821011",1.38786315682739,1863,999,864,245.078195864525
"0179821013",1.5688180904638,1409,1116,293,252.775962298711
"0181521011",0.206074327138019,734,49,685,247.587426404049
"0181521032",2.13450477224716,2670,1343,1327,236.976970515803
"0181521046",1.62703703431178,2412,1157,1255,238.686405620818
"0181521065",1.62593893318818,2198,1154,1044,242.455497211327
"0181821001",1.38532980781634,2338,998,1340,236.598363372942
"0181821008",0.377797047136825,965,136,829,245.644936565184
"0181821014",0.431984475291104,1391,174,1217,239.545450093321
"0181821015",0.650020129286076,1268,346,922,244.176745965294
"0181821018",0.846064100396541,1536,510,1026,242.705175983175
"0182121004",1.36500808227181,1555,982,573,249.062211617291
"0182121009",0.387223342929322,1053,145,908,244.416392473472
"0182121018",1.33979244195667,2105,962,1143,240.772619325328
"0182121033",1.24632923131845,2165,883,1282,238.130845956719
"0182121036",0.508796502426511,1025,231,794,246.040088100376
"0182321003",0.894994839889947,1482,561,921,244.186978011392
"0182321012",0.504007213528925,1054,226,828,245.650372632204
"0182321027",0.871067779966995,1194,538,656,247.972949928365
"0182321029",1.00891174660755,1586,662,924,244.16837152991
"0182321040",1.4034970470536,2184,1014,1170,240.482964122504
"0182921003",1.35704158814916,1554,978,576,249.032295277101
"0182921035",2.88376779127647,1764,1519,245,253.446821714103
"0182921044",1.28785512013132,1340,914,426,250.797962850745
"0182921047",0.950653011965426,1187,606,581,248.982863548718
"0182921081",1.85033283717338,1875,1248,627,248.404537041329
"0183421003",1.15490168181108,2118,803,1315,237.207353011388
"0183421016",1.43657774190507,1060,1030,30,259.406216547547
"0183421040",0.396038738392818,1140,151,989,243.244577659807
"0183421041",0.907766308820829,1974,572,1402,234.293892873758
"0183421058",0.77324976316447,1575,441,1134,240.963130554464
"0183921002",0.609430295290418,438,316,122,255.872135859717
"0183921004",1.44463937759879,2077,1035,1042,242.470070603984
"0183921005",0.320695205590221,290,100,190,254.431243283157
"0183921006",1.69904208432219,1734,1195,539,249.530597059009
"0183921008",0.69554839788859,1240,378,862,245.124601027266
"0184921004",0.2080896738659,1381,51,1330,236.887729113684
"0184921008",1.19112974035684,1514,831,683,247.608995868533
"0184921038",1.48732235948499,2174,1063,1111,241.367525460123
"0184921057",0.552014295282715,1640,274,1366,235.815467803722
"0185221005",0.895177599149975,1675,562,1113,241.307007773298
"0185221008",0.922083216142405,1435,584,851,245.290360947901
"0185221009",0.830328090790503,793,493,300,252.695590525419
"0186121005",1.47535086345107,2242,1054,1188,240.049255789171
"0186121018",0.65946107066759,1323,354,969,243.59772037551
"0186121024",0.370632880192319,550,126,424,250.801586945668
"0186121025",0.870821335820101,1271,537,734,246.80252705806
"0186121033",1.27537094667851,2358,906,1452,230.800841988464
"0186721005",0.214060032741952,1511,53,1458,230.239719633969
"0186721009",0.353461793294709,1692,119,1573,209.310361945811
"0186721010",0.620323648723711,1830,322,1508,224.226170386771
"0186721040",1.04722329523481,1566,697,869,245.01201350522
"0186721046",1.25049263345113,2219,888,1331,236.773693840313
"0187021016",1.09625190511356,1007,742,265,253.187715518221
"0187021018",1.73443954273488,2558,1210,1348,236.432885941397
"0187021022",0.464852019352673,396,196,200,254.267995649974
"0187021037",1.69734751528423,2531,1194,1337,236.650706847367
"0187021048",0.754281160363799,1226,430,796,246.007987458815
"0187321007",0.468259583629147,1261,199,1062,242.221414739788
"0187321012",2.80601964264757,2829,1504,1325,237.004590291155
"0187321013",2.71208863607116,2887,1486,1401,234.341326115449
"0187321014",1.14474597603347,1681,793,888,244.72626494822
"0187321015",1.88908464513764,2623,1260,1363,235.899777594524
"0187521022",3.9681393464963,1809,1591,218,253.853512295112
"0187521033",1.80416432237002,1744,1238,506,249.84829860542
"0187521041",2.82593893139292,2298,1510,788,246.112066492292
"0187521049",1.64589911949406,1505,1166,339,251.87799009328
"0189121007",1.11271075615421,1333,761,572,249.07008256887
"0189121032",1.38344068569761,1933,994,939,243.946913577372
"0189121055",0.577103700021538,1296,290,1006,243.055280059652
"0189121056",0.860287940672285,820,524,296,252.760362270651
"0189121060",1.51628577212358,1496,1082,414,250.92740680328
"0190521001",1.55224949525205,1683,1104,579,249.011627041374
"0190521014",1.24613646309149,1289,882,407,250.997892859403
"0190521020",1.60088689153078,2166,1137,1029,242.656232475344
"0190521025",1.89349199943013,2618,1261,1357,236.14698879778
"0190521027",1.91381151828366,2015,1269,746,246.654392625974
"0190721001",0.373482841716955,1295,132,1163,240.564608142927
"0190721002",0.642369918329934,1189,343,846,245.331208318786
"0190721006",0.75344767859713,1265,428,837,245.517171676512
"0190721007",0.524244613545576,1319,247,1072,242.057672235378
"0190721036",0.837382541241056,1729,504,1225,239.336113813862
"0190921001",0.631287620666121,1034,334,700,247.321572487902
"0190921007",1.63386943814556,2152,1158,994,243.172631510671
"0190921016",0.912387196583602,1361,575,786,246.144623514035
"0190921026",0.385976895043231,345,144,201,254.257093531674
"0192421005",1.55558321528306,1815,1108,707,247.221232105279
"0192421007",0.634263931579329,450,335,115,255.974913705263
"0192421009",1.62352808771843,1278,1152,126,255.770370049934
"0192421021",0.883293305860162,784,553,231,253.667244319766
"0192421033",0.514476844644636,260,238,22,260.421083213083
"0197521019",1.21374221019209,2355,848,1507,224.264967649841
"0197521025",2.2331856252332,2866,1370,1496,226.06794614346
"0197521028",1.46209690118951,2531,1046,1485,227.008754960185
"0197521044",1.58924494565547,2678,1130,1548,217.719308478763
"0197521052",1.4009984924187,2544,1013,1531,220.391719633965
"0198721011",1.85106424687203,2693,1251,1442,231.87812123029
"0198721031",0.753623053311177,638,429,209,254.046435122183
"0198721034",0.345467553290981,1699,113,1586,203.361519161658
"0198721042",1.01261066188243,1650,665,985,243.277644972482
"0199221006",1.28626488503734,2495,913,1582,206.201339238259
"0199221008",1.23738494758995,2341,873,1468,229.10824344349
"0199221012",0.480901668098127,1729,208,1521,223.163836697455
"0199221026",0.491730974557051,1393,217,1176,240.399215325005
"0199221083",0.836127252230097,1922,502,1420,233.438235727444
"0199421014",1.07728489262196,1766,718,1048,242.440862972745
"0199421015",0.736081879003977,1590,411,1179,240.30178015986
"0199421020",1.17977960409484,2258,822,1436,232.39713353488
"0199421022",1.71908861902019,2424,1204,1220,239.42705246626
"0200521003",0.286154194680203,969,84,885,244.80781162531
"0200521005",0.667004323705361,1360,360,1000,243.097194441567
"0200521007",0.553852334769718,1799,277,1522,222.472814909239
"0200521008",2.90993656570725,3058,1524,1534,219.661088240668
"0200521010",0.151440317803547,843,22,821,245.757147924814
"0204621002",1.91639772966637,2846,1270,1576,209.010857641016
"0204621003",1.17201506292681,2350,817,1533,219.694721346743
"0204621006",1.08187857391984,851,723,128,255.681804290052
"0204621010",4.25785015323485,3171,1597,1574,209.261566584838
"0204621013",1.14205173395248,2319,790,1529,220.68698220011
"0205021005",1.12805455832139,1202,779,423,250.811042325163
"0205021046",1.29455449559055,1625,920,705,247.258075454075
"0205021051",0.970044596810911,720,625,95,256.659065633646
"0205021054",1.38474952750567,1741,997,744,246.684479995517
"0206221001",2.78722598349676,2930,1498,1432,232.660694742191
"0206221005",1.32943228125242,1642,954,688,247.568841026463
"0206221006",0.878919580492563,714,544,170,254.737059280431
"0206221007",1.22038329589713,978,858,120,255.917744545783
"0206221011",0.931965738786809,1452,594,858,245.18536403432
"0206321015",1.68759149250413,1216,1185,31,259.374472279471
"0206321022",0.808531569435905,1190,477,713,247.08807765866
"0206321027",1.08597704594433,833,731,102,256.459898848923
"0206321044",0.533920414418762,944,257,687,247.572172455837
"0206321068",1.24301310166735,2275,878,1397,234.425083473083
"0206921011",0.883014676131143,924,551,373,251.324170640487
"0206921014",0.903974970644147,590,566,24,259.966234661287
"0206921018",2.3594015980513,2472,1397,1075,242.04128431256
"0206921026",2.32837868742535,1458,1387,71,257.6260334186
"0207921001",1.62618283567235,1237,1156,81,257.214982903393
"0207921011",3.65754931864717,1776,1582,194,254.363965786528
"0207921024",0.543234935161981,303,266,37,259.094732707755
"0207921027",1.69385052394772,1539,1190,349,251.724272301032
"0207921031",1.34804048930257,1077,970,107,256.286730380844
"0208021007",1.00055758543906,2130,654,1476,228.146439872063
"0208021009",1.39949610317554,2245,1009,1236,239.098392914389
"0208021017",0.87903902503869,2106,545,1561,213.909031403097
"0208021024",0.218039745542753,1441,54,1387,234.747271882647
"0208021028",0.166065830947168,1420,28,1392,234.622224704513
"0208121007",0.906537158979878,1306,570,736,246.779087002709
"0208121008",0.807411083441251,1217,472,745,246.675079302076
"0208121011",0.198898985791059,925,44,881,244.866067397316
"0208121019",0.452076854561072,1057,185,872,244.977059581056
"0208121020",1.30393381593671,2219,931,1288,238.013855656897
"0208421013",1.75008253342807,1383,1214,169,254.74941724537
"0208421026",1.12533926573714,1817,774,1043,242.457817849147
"0208421027",1.15643254589401,1233,804,429,250.766922002766
"0208421036",1.75784881700348,1348,1218,130,255.654318369709
"0208421040",2.56002453381504,1913,1453,460,250.405033038721
"0210021003",1.30820067467514,1062,937,125,255.790679453209
"0210021005",2.59738868338234,1931,1460,471,250.267330559389
"0210021007",0.965082706923361,1556,618,938,243.950339048168
"0210021010",1.5611243174374,1265,1110,155,255.127690439769
"0210021019",1.20595808553094,1400,842,558,249.236265228169
"0211021006",0.548531574501059,813,271,542,249.447777780038
"0211021007",0.505715020122864,1087,227,860,245.15564834569
"0211021012",1.23150650328345,1945,868,1077,241.985260432914
"0211021018",0.638908421704009,487,341,146,255.379496590036
"0211621010",0.480321262238452,837,207,630,248.366206406454
"0211621013",0.493030196857068,861,218,643,248.129983963773
"0211621026",0.849117324078296,828,517,311,252.55468414014
"0211621031",0.363602556293762,1231,124,1107,241.40464886677
"0211621040",1.37243103341672,1873,987,886,244.780036152327
"0212521007",1.27466341555398,2453,904,1549,217.355474197523
"0212521010",1.40078455866896,2411,1011,1400,234.389941183145
"0212521034",1.52840305999978,2632,1089,1543,218.109043291829
"0212521040",1.30134259607778,2436,925,1511,223.90542727875
"0212621008",1.13262985630645,915,784,131,255.630486925054
"0212621011",0.650478180877927,466,347,119,255.923485442736
"0212621019",0.535962947668733,303,259,44,258.806235552531
"0212621021",1.19078700927437,973,830,143,255.420580360245
"0212621030",0.937189104202384,874,597,277,253.056974986933
"0213021006",1.31820694483973,2108,946,1162,240.564717208921
"0213021010",1.17144473766861,2072,815,1257,238.655039880081
"0213021017",0.808492915973696,1888,476,1412,233.843039960247
"0213021019",0.326282272548033,1132,102,1030,242.648279157777
"0213321008",1.35152913897622,2371,973,1398,234.419134877676
"0213321017",0.861163240351487,1870,528,1342,236.539840665713
"0213321030",1.29890341152797,2213,923,1290,237.950162314742
"0213321031",1.65280512779035,1261,1167,94,256.705049021866
"0213321032",0.684233495293868,1489,368,1121,241.153879907335
"0213521004",2.81924854597993,3109,1508,1601,178.440041695272
"0213521009",1.42481256468393,1562,1024,538,249.532248395636
"0213521012",0.645299101902843,1785,344,1441,231.946785991994
"0213521023",1.29400471815412,1718,919,799,245.980530260071
"0216321073",1.21926438690335,1465,857,608,248.617365009378
"0216321076",1.45228711107612,1958,1041,917,244.272508962219
"0216321078",0.924114533936641,934,586,348,251.729679345464
"0216321085",2.06078218423353,1775,1319,456,250.441450298989
"0217321006",0.92039364583911,1719,581,1138,240.838883374548
"0217321048",0.499559668144842,1280,224,1056,242.280233812082
"0217321052",0.587838083225771,1679,296,1383,234.874282905572
"0217321055",0.130747296460481,1136,17,1119,241.163873033034
"0217921016",1.3384307734033,1782,959,823,245.729490337031
"0217921018",1.52095922455272,2525,1085,1440,231.948750400652
"0217921026",1.39703446635632,1806,1006,800,245.969618582476
"0217921031",1.0845555650006,1291,729,562,249.178159739268
"0217921032",1.05888262385782,1956,705,1251,238.740926649993
"0218121015",1.39098395746417,2462,1001,1461,230.193235286523
"0218121023",1.08338678825729,2220,727,1493,226.302067517567
"0218121030",0.640336165048702,626,342,284,252.949587619376
"0218121046",0.80808348949162,1688,475,1213,239.600953099573
"0218121062",2.0247622677062,2781,1307,1474,228.457728231854
"0218321002",1.55567219411378,1314,1109,205,254.097674828834
"0218321003",1.94493838296207,1872,1277,595,248.749224491943
"0218321006",1.21417283364122,1354,849,505,249.885168981481
"0218321016",2.03363162826797,1765,1312,453,250.476447991922
"0218321019",0.676501567122739,975,366,609,248.614614117364
"0219321003",0.606380077573511,1404,312,1092,241.756998473954
"0219321019",1.08209347451567,1533,724,809,245.887529378237
"0219321022",0.848571100682357,1972,516,1456,230.326423117214
"0219321023",0.71991958747722,1194,404,790,246.083867802239
"0219321035",0.790418209287893,1792,458,1334,236.723116198824
"0222121001",0.206953519010442,851,50,801,245.945522103103
"0222121005",0.661318887339989,591,355,236,253.618979775059
"0222121006",1.16275079870903,981,808,173,254.63674344349
"0222121012",0.343022087740242,505,109,396,251.107418818269
"0222221001",0.957324549024863,1366,611,755,246.549640489343
"0222221022",1.34914007527971,1802,971,831,245.58981795848
"0222221057",1.06709671873202,1916,712,1204,239.722624593089
"0222221062",1.19145506906337,2127,832,1295,237.85478849776
"0223021009",1.21884305576976,910,856,54,258.451894040433
"0223021027",0.836971340659799,757,503,254,253.322272693244
"0223021031",1.12919829515178,1193,781,412,250.952682291667
"0223021051",3.02032789958773,1601,1540,61,258.13659866726
"0223021054",1.10304696476756,1297,752,545,249.363614717007
"0224121001",2.00716840159957,1530,1301,229,253.670267278439
"0224121002",2.59443006599966,1502,1459,43,258.830010687229
"0224121003",1.24904140050822,913,885,28,259.624710625601
"0224121017",2.97977530637487,1728,1531,197,254.337570538315
"0224121019",2.10668858262944,2034,1337,697,247.375472459339
"0225621002",1.09846312865723,1628,745,883,244.848920972753
"0225621011",0.880251082001633,805,548,257,253.302571125068
"0225621016",1.2369584505669,1519,872,647,248.076917605748
"0225621023",0.605721541100626,832,311,521,249.694652855067
"0225621030",1.75701424712506,2630,1217,1413,233.827671794462
"0225921005",2.45342588211322,2019,1427,592,248.768991344698
"0225921026",2.46541255999126,1444,1429,15,260.925888954616
"0225921028",2.12144403819712,1352,1340,12,261.432002046625
"0225921031",1.08410343427499,1230,728,502,249.906603281154
"0225921032",2.02681084049838,1783,1309,474,250.236792539361
"0227221004",3.64653630919723,1828,1580,248,253.443196593915
"0227221015",0.863876467952645,872,529,343,251.821502570346
"0227221041",2.10130309000245,2276,1333,943,243.894822226177
"0227221046",0.592764061246565,1064,300,764,246.490302923196
"0227221050",0.799259747440868,1465,467,998,243.101731094662
"0228721004",1.79337533751548,2770,1235,1535,219.650908627074
"0228721011",2.181428452296,2944,1356,1588,202.729021221273
"0228721021",0.648546460371542,1936,345,1591,200.066287117404
"0228721023",1.42623250650161,2549,1026,1523,222.279822808573
"0228721025",1.84176600099253,2833,1243,1590,201.387968850324
"0230021040",0.694392828081122,1570,376,1194,239.984482861483
"0230021043",0.91961188851744,1714,579,1135,240.953868884404
"0230021049",0.166133920499413,515,29,486,250.119274528147
"0230021094",0.510119021191462,1427,234,1193,240.003577698739
"0230021102",0.115534097793719,1421,15,1406,234.114285110156
"0230921010",1.31008005493046,1573,940,633,248.349129907335
"0230921015",1.03899627690407,2245,687,1558,214.495226154801
"0230921028",0.627795623313562,1293,330,963,243.676187887938
"0230921081",0.564269782019804,751,284,467,250.297299880881
"0230921113",1.079554726445,1114,720,394,251.143150869824
"0231021032",1.58931021386488,2712,1131,1581,206.780011390032
"0231021065",1.71492772828072,2774,1202,1572,209.944595201002
"0231021071",0.827631700421546,2038,491,1547,217.775778657496
"0231021081",3.55407653304034,3074,1577,1497,225.98932008297
"0233021010",1.27208905819126,2347,902,1445,231.571167151954
"0233021011",1.65907096703161,2714,1170,1544,218.072864287821
"0233021037",1.47680588299246,2554,1055,1499,225.767098285728
"0233021041",0.864431650145253,1098,530,568,249.123046493834
"0233021043",1.50039083577376,2443,1074,1369,235.655568235964
"0234921010",0.847986140735721,2027,515,1512,223.834879225916
"0234921011",0.708084354814291,1217,391,826,245.690016631724
"0234921012",0.238550632891577,609,59,550,249.296801603916
"0234921026",0.404209177945628,1451,160,1291,237.944157244197
"0238121004",2.2647228989395,1412,1376,36,259.213771660053
"0238121006",1.86935385795906,1567,1255,312,252.534957747149
"0238121028",1.27493373364847,1137,905,232,253.666956360563
"0238121033",1.83465258366057,1478,1241,237,253.537108713624
"0240821005",0.300536511890838,871,92,779,246.246897642211
"0240821007",0.54785980018537,457,270,187,254.463217795515
"0240821009",3.41689817487642,1801,1573,228,253.692397405452
"0240821012",1.81253323074324,1411,1240,171,254.736662568807
"0240821020",1.34528410882777,1279,966,313,252.511595495125
"0241021001",1.33961579555682,1326,961,365,251.437224924973
"0241021005",0.507831326838315,1166,230,936,243.956748538038
"0241021009",1.96724124391324,2372,1286,1086,241.879762623386
"0241021014",1.70912785883213,2608,1200,1408,234.058643106311
"0241021056",0.752741012104922,859,427,432,250.726827705495
"0241721001",1.1358204624759,2023,785,1238,239.089924439965
"0241721003",1.30020469335863,1740,924,816,245.813212358835
"0241721006",0.706964339987342,999,388,611,248.603841687838
"0241721027",0.77514856556575,1338,444,894,244.607674439964
"0241721041",0.956297066244612,1583,608,975,243.502983522856
"0242021010",1.30275122183713,1730,928,802,245.935440312978
"0242021019",0.404749905170841,424,161,263,253.221760599174
"0242021027",0.978844635933897,1418,633,785,246.178546694251
"0242021030",1.05185546389531,1818,700,1118,241.183195784359
"0242021039",1.1037162021411,1372,754,618,248.502108156839
"0242621001",0.707083605609429,909,390,519,249.72248623467
"0242621005",2.72185021863919,1629,1487,142,255.44605272665
"0242621008",1.31428707847033,1135,943,192,254.373926730099
"0242621012",2.11227336579006,1643,1338,305,252.659184704185
"0242621014",2.18947335665116,1565,1357,208,254.065404379622
"0242821008",1.24920492713725,2310,886,1424,233.242813990228
"0242821013",1.68019707603448,2079,1179,900,244.549661873826
"0242821017",1.6224837405558,2449,1150,1299,237.756199945323
"0242821020",0.514265513227668,1721,237,1484,227.089662314744
"0242821025",0.612122418237762,1611,318,1293,237.923660110158
"0243021003",1.89876436261963,2833,1263,1570,210.667108852204
"0243021027",2.51786635394236,3021,1441,1580,206.803567769115
"0243021030",3.72685890594951,3152,1585,1567,211.370253109911
"0243021035",3.11321495999104,3141,1552,1589,202.657222986365
"0243021040",2.90587863276047,3107,1523,1584,204.895272764481
"0243721005",0.992232519306935,1934,649,1285,238.034936565184
"0243721007",1.14091406332534,1755,789,966,243.631747343912
"0243721011",0.62300640111256,1316,326,990,243.241547556042
"0243721012",1.12328958770769,1174,773,401,251.052197367653
"0243721013",0.684722333584714,1910,369,1541,218.631269271291
"0244521019",0.802326538052643,789,468,321,252.247662052068
"0244521025",2.85356571463167,1620,1516,104,256.401006974507
"0244521047",1.292801171203,1692,916,776,246.28082349537
"0244521050",0.61047826436307,381,317,64,257.975250515951
"0245421001",0.295453064417447,792,89,703,247.272328127128
"0245421003",1.01120106784851,917,664,253,253.373796647787
"0245421010",3.66011819359316,1778,1583,195,254.357939938657
"0245421014",1.30380028121055,1079,930,149,255.265622685185
"0245421020",2.79645752709767,1517,1500,17,260.722138243236
"0246621006",1.50035479336572,2051,1073,978,243.482466327091
"0246621021",1.16219374567481,1677,807,870,244.987502310509
"0246621026",0.589410001705674,1448,299,1149,240.69476627097
"0246621064",0.969473432286935,2067,623,1444,231.707642914392
"0246621067",0.910837701436901,1627,573,1054,242.29736116836
"0247021016",3.18114147065524,1822,1561,261,253.282650380291
"0247021017",0.482006957670227,699,209,490,250.106885856144
"0247021018",2.69003188390094,1924,1477,447,250.517366705672
"0247021020",1.96642030588686,1323,1285,38,259.081249442655
"0247021021",2.41845908071735,1847,1416,431,250.763841038668
"0247921001",2.39323719213562,1411,1407,4,263.946899440476
"0247921004",2.7599265214987,1807,1490,317,252.400774197126
"0247921014",2.22729430575104,1772,1367,405,251.004355750232
"0247921018",1.56814513104655,1297,1115,182,254.542719936844
"0247921021",0.524206161268334,743,246,497,249.973120152417
"0248621010",1.31989715659893,1419,947,472,250.238961988408
"0248621012",0.100278147124377,1575,10,1565,212.343961975148
"0248621020",1.85047617357317,2429,1249,1180,240.259580143828
"0248621034",1.14384493661472,2331,791,1540,218.693324932234
"0248621040",0.437939493650351,1747,179,1568,211.280499402245
"0251341016",0.792754786958214,2056,461,1595,186.929766047594
"0253441026",0.98184619040223,1901,637,1264,238.509682877513
"0253441044",0.53191018177965,1010,252,758,246.537775189522
"0253441052",1.90575891701335,2623,1267,1356,236.165910330616
"0253441119",0.974585433594941,1653,628,1025,242.713860727441
"0253441121",1.44829965200207,2112,1039,1073,242.049693665917
"0255141011",1.6446593999379,1260,1164,96,256.642578621032
"0255141020",0.265792556894533,439,77,362,251.468622508367
"0255141048",1.35574031782184,1069,976,93,256.709504351356
"0255141079",1.1779315929794,1542,819,723,246.982541494141
"0255141083",2.81479786619285,1663,1506,157,255.056405517415
"0258641006",1.98884967546841,1987,1296,691,247.493438226432
"0258641011",2.36702012237796,1666,1399,267,253.165619782316
"0258641081",1.26887851298118,1732,900,832,245.586560906686
"0258641082",2.14881445822756,2005,1346,659,247.890637325637
"0258641084",1.93889333681237,1948,1275,673,247.718558614418
"0279341003",0.986815721507869,1960,644,1316,237.196534007867
"0279341016",0.80782079646371,1400,474,926,244.123879586669
"0279341027",0.47629900942721,766,205,561,249.190919369416
"0279341029",1.99770639164941,2710,1299,1411,233.874328981409
"0279341042",0.950649721279167,673,605,68,257.758917826206
"0280241009",2.78929862823213,2518,1499,1019,242.820432653909
"0280241014",3.13262657703284,2253,1555,698,247.337712703646
"0280241019",2.01373724708896,1355,1302,53,258.587831460479
"0280241028",0.974893276989403,1791,630,1161,240.565876758637
"0280241051",3.08061459181857,2196,1550,646,248.091194767617
"0280641011",1.29316383484654,1306,917,389,251.196462358834
"0280641029",1.4240374024895,2501,1022,1479,227.63754062162
"0280641033",1.90228825368298,2553,1266,1287,238.01392914976
"0280641038",0.629079852285347,1230,331,899,244.554658346489
"0283141007",0.52148393071395,1009,243,766,246.463628492572
"0283141012",1.0197590659818,2146,673,1473,228.535330083703
"0283141018",1.41815991294246,1646,1020,626,248.427679530552
"0283141025",0.176580891199097,814,37,777,246.272313769769
"0283141041",1.47533110341775,2089,1053,1036,242.56438078917
"0288241004",1.17128858018632,2161,814,1347,236.434083831497
"0288241005",1.04008005036854,2064,688,1376,235.244221838551
"0288241011",0.682210393122561,1581,367,1214,239.596018575765
"0288241017",1.19068175125772,1501,829,672,247.728115637652
"0288241021",0.723264184477959,1834,406,1428,232.787077879115
"0288341007",0.868765422045155,1536,534,1002,243.084698049069
"0288341011",1.61005838620058,2310,1144,1166,240.536277394106
"0288341012",0.258388404380816,1194,71,1123,241.132357605104
"0288341017",0.657295551392525,608,352,256,253.310832669081
"0288441005",0.675070937270091,903,363,540,249.529777614566
"0288441013",0.713959711303286,1164,397,767,246.429792164831
"0288441021",0.911859673179303,795,574,221,253.807974305414
"0288441026",1.0613163335359,1240,709,531,249.608925983173
"0288441035",0.948663716955908,888,603,285,252.942960374708
"0289041008",1.26291006284941,1497,895,602,248.662182775368
"0289041011",0.14744416901622,1060,20,1040,242.498058058746
"0289041015",2.44829299783709,2672,1422,1250,238.767315272894
"0289041019",1.44744976110265,2029,1037,992,243.195371088992
"0289041023",0.578863370166814,513,291,222,253.759908923484
"0290041025",2.23218146123336,1613,1369,244,253.447729249339
"0290041046",2.82435553612716,1518,1509,9,261.536677037885
"0290041065",1.31314808506598,1440,941,499,249.965553203163
"0290041068",2.92766144551932,2040,1526,514,249.774106902357
"0290041079",1.74579393528092,1549,1213,336,251.928767939815
"0290541004",3.5284009926821,1658,1576,82,257.08830174513
"0290541005",3.31192326021106,1871,1568,303,252.681400710979
"0290541007",1.48289585933081,1348,1059,289,252.873519110157
"0290541054",2.31818248134861,2288,1382,906,244.424136160714
"0291641036",0.890858330436822,722,557,165,254.848100965935
"0291641039",0.304948023378499,161,95,66,257.833369080074
"0291641053",1.41508352962078,1030,1019,11,261.462675743392
"0291641055",1.44199869395342,1117,1034,83,257.064111182841
"0291641065",1.57129005758039,1433,1119,314,252.48855029102
"0292341011",2.49269468898553,2443,1435,1008,242.984658190242
"0292341015",0.658815306498582,1595,353,1242,239.023784999928
"0292341016",0.184185275072311,1133,39,1094,241.713482921604
"0292341018",0.971167237122267,2030,626,1404,234.265316244917
"0292341026",1.04018656331288,1266,689,577,249.021941415272
"0292341054",1.18176354668002,1725,823,902,244.531240176695
"0292641012",0.50340062764068,257,225,32,259.358956000508
"0292641022",1.68869347229586,1520,1186,334,251.94162214406
"0292641026",2.42305058431499,2459,1418,1041,242.496832448842
"0292641030",2.48779815972544,1476,1434,42,258.866210400094
"0292641047",2.43288101465623,1425,1420,5,262.475346765636
"0292841006",2.08086269752658,1646,1324,322,252.232121211296
"0292841013",1.46697844014423,1358,1048,310,252.555219852048
"0292841016",1.0887601582504,1956,735,1221,239.416415875465
"0292841037",1.79242049689521,1498,1234,264,253.193851295042
"0292841093",2.27870905665195,1952,1378,574,249.048179999399
"0292941004",2.09813962510843,1334,1331,3,264.949708250661
"0292941010",1.32252014667253,1092,951,141,255.446194245087
"0292941021",2.45194967995008,1604,1425,179,254.588385578204
"0292941026",0.17668918786447,657,38,619,248.493922522278
"0292941028",1.35867409451442,1066,979,87,256.920331251587
"0293441006",0.89152055097029,1974,558,1416,233.606319139401
"0293441016",0.785940896131401,1370,455,915,244.303081406452
"0293441022",1.24851854555845,1729,884,845,245.336855676936
"0293441043",0.609233149920505,1313,314,999,243.098467067091
"0293441053",0.396778922970536,1449,152,1297,237.838159097543
"0293841003",2.14596436060799,2763,1345,1418,233.497109184232
"0293841049",0.860462205017645,1121,525,596,248.740064909237
"0293841059",1.72101833864264,1863,1206,657,247.955511080174
"0293841067",1.2369433304489,1230,871,359,251.496519898517
"0314321014",0.600657932293125,910,307,603,248.657733081939
"0314321032",0.329643430818443,289,105,184,254.502959441979
"0314321035",1.52635880220088,1219,1087,132,255.628253584584
"0314321036",0.833394845382542,837,500,337,251.910851027265
"0314321037",1.04455365163486,1048,694,354,251.641043407415
"0317621005",3.29281832093535,2059,1566,493,250.044820657006
"0317621008",0.785314560965881,922,453,469,250.268818556165
"0317621022",1.56499330708546,2352,1113,1239,239.084113813859
"0317621045",0.807478451490354,1484,473,1011,242.955430833262
"0317621049",0.532793613302367,1439,255,1184,240.112082729206
"0320421039",1.73209428374646,1773,1209,564,249.156181494637
"0320421043",0.292985680377286,927,87,840,245.449571786444
"0320421048",0.613452014953497,1368,319,1049,242.437858083199
"0320421049",1.06009522347942,1853,707,1146,240.738670131001
"0320421059",0.465519701507744,729,197,532,249.60121610663
"0326121005",0.778047078170284,1123,446,677,247.67320369933
"0326121014",0.466763921920061,1262,198,1064,242.150760719981
"0326121017",1.1514616099359,1597,799,798,245.98908661974
"0326121027",0.585113337475012,1360,292,1068,242.110947127152
"0326121030",0.294240742240029,961,88,873,244.976649748605
"0327621013",0.359591946333962,1441,120,1321,237.07315323586
"0327621021",0.904222222807701,1321,568,753,246.557333391559
"0327621030",0.384227694013618,258,141,117,255.925159448782
"0327621060",1.4130143800865,2257,1016,1241,239.073524969064
"0327621064",0.408729176108524,1060,167,893,244.623074131324
"0330921006",1.25755632865236,1023,894,129,255.670764070829
"0330921028",1.11207069247642,1210,759,451,250.487716765873
"0330921046",0.766161673826774,589,435,154,255.164790779317
"0331521007",1.11256999523992,1392,760,632,248.357948690404
"0331521012",0.455196767194848,212,187,25,259.8489859479
"0331521023",0.755189786097446,1396,431,965,243.650663751818
"0331521039",1.20093843001444,1410,840,570,249.088956923947
"0331521042",0.836011189634839,686,501,185,254.49066121245
"0331921003",1.22046192977911,1309,859,450,250.497060462891
"0331921010",0.708347681154159,1893,392,1501,225.348323758212
"0331921017",0.401457503811147,753,156,597,248.720486609275
"0331921022",0.196337743135871,487,43,444,250.568512623386
"0331921026",1.19398080445876,1765,834,931,244.054753364126
"0332621008",1.51383561762894,2278,1081,1197,239.930995247242
"0332621017",2.93566417805198,2292,1527,765,246.470227129558
"0332621018",1.86005716313892,2128,1253,875,244.94125280338
"0332621021",0.421731810768949,609,169,440,250.62036381386
"0332621024",0.347791586293119,412,115,297,252.747708831499
"0333521043",0.405262384440026,1701,163,1538,218.9525293914
"0333521047",0.877159042015299,1812,543,1269,238.478508875591
"0333521051",0.316056265305754,622,99,523,249.679019016683
"0333521066",2.58925955564873,2922,1456,1466,229.702250057246
"0333521078",0.188134754257706,1104,41,1063,242.202912619995
"0333721002",0.524461313415207,1063,248,815,245.851085374707
"0333721003",0.526833519765783,1083,249,834,245.563191415271
"0333721020",0.709920180237432,1368,395,973,243.523009211527
"0333721022",1.61497799139142,2357,1148,1209,239.669667545623
"0334221011",1.20350377201316,1262,841,421,250.844456537097
"0334221017",1.46035059444325,1156,1043,113,256.062611937831
"0334221021",1.08010739353576,1067,722,345,251.79444364275
"0334221053",2.34077381863081,1992,1393,599,248.681521246693
"0334221058",1.80357361572859,1716,1237,479,250.156506696429
"0335621002",0.587119838224284,1487,295,1192,240.01457774345
"0335621010",0.260663694933151,1448,73,1375,235.287361388818
"0335621038",0.773607345677463,2035,442,1593,197.729040534328
"0335621039",0.585712338120963,1723,293,1430,232.683186825725
"0336121008",0.732777739723072,1597,410,1187,240.058805612804
"0336121019",0.727007905047261,1422,407,1015,242.901959913747
"0336121022",0.77508082130994,834,443,391,251.186617541614
"0336121023",1.06757449248774,2231,713,1518,223.345372050992
"0336121026",0.958050820264089,2029,612,1417,233.596860727443
"0337721020",0.296453745728102,761,90,671,247.765178526925
"0337721025",2.53610983639508,2410,1448,962,243.680214944214
"0337721047",0.7003756610965,1604,381,1223,239.372563769768
"0337721063",0.778550115855474,1115,448,667,247.802605656894
"0337721067",0.972403807556242,1398,627,771,246.392948469946
"0337921041",1.26716556178351,1181,898,283,252.969823530071
"0337921069",2.07675456945212,2085,1323,762,246.491166964415
"0337921106",0.926838306684315,700,589,111,256.12256950169
"0337921122",1.11106085527805,1253,758,495,249.978957729205
"0338621019",1.41344148989249,1409,1017,392,251.180060242432
"0338621020",1.00461918290077,1522,657,865,245.058093854149
"0338621024",0.487064723336927,1418,211,1207,239.692009312153
"0338621044",0.803162155188785,1110,469,641,248.159961096204
"0342121009",0.254160964622035,546,68,478,250.160605035602
"0342121012",0.426264555470486,1691,171,1520,223.178432131054
"0342121017",0.250302321546295,1532,65,1467,229.625471495222
"0342121021",0.333082007069302,216,107,109,256.243224924971
"0342121022",0.288547088147996,1603,86,1517,223.431044790295
"0342221005",2.02513262783822,2455,1308,1147,240.730590269357
"0342221024",1.10925452374888,1386,757,629,248.374703465904
"0342221029",0.710195371989534,1406,396,1010,242.956017473472
"0342221033",1.48519925960563,2280,1062,1218,239.473877041373
"0342221036",1.54867555115602,2275,1100,1175,240.407255348251
"0343421013",1.64396682490716,2059,1163,896,244.601251326279
"0343421014",0.406886314326117,1060,165,895,244.603988448534
"0343421029",0.91353560694325,1341,578,763,246.491053214236
"0343421035",1.86561453081801,1522,1254,268,253.144966249827
"0343421040",1.52374617153908,1236,1086,150,255.252314350634
"0343621005",1.85058808398643,2207,1250,957,243.701568619857
"0343621011",1.3176636046877,2253,945,1308,237.406877892236
"0343621013",0.830588294870033,1916,494,1422,233.430082105125
"0343621017",1.41967401895688,2203,1021,1182,240.193808498806
"0343621036",0.856726040521912,1273,521,752,246.562634096048
"0345421008",2.96171725166105,1808,1529,279,253.035444775132
"0345421021",2.37421874381313,1891,1402,489,250.110636040439
"0345421026",3.07058805917717,1822,1549,273,253.099232721561
"0345421032",2.20997565075508,2790,1364,1426,232.922310443244
"0345921025",0.868616851112557,1907,533,1374,235.338054290053
"0345921039",1.03760047634449,2167,686,1481,227.275898717603
"0345921047",0.0916163870989389,1185,7,1178,240.309191234897
"0345921053",0.991325829640735,1990,646,1344,236.525262082258
"0345921055",1.17053122613351,1657,813,844,245.34739970852
"0346021002",1.5783070529991,2612,1124,1488,226.794345400236
"0346021009",1.21373966121082,1701,847,854,245.242862050192
"0346021013",2.51557625923193,2175,1440,735,246.780093365245
"0346021014",1.36596805493526,2265,984,1281,238.135856979646
"0346021015",1.25677609953119,2243,893,1350,236.37190754482
"0347321001",1.60879471844575,1510,1142,368,251.367326115448
"0347321019",1.34800772771875,2372,969,1403,234.28203312603
"0347321029",1.0448624917373,1734,695,1039,242.504101909098
"0347321032",0.994050057943505,1834,651,1183,240.124782716701
"0347321041",1.38382401451744,2204,996,1208,239.670527173649
"0347921019",1.26683843169431,1480,897,583,248.955920251251
"0347921034",1.00989222310173,1249,663,586,248.889015469304
"0347921040",0.532401608553171,782,254,528,249.628017084973
"0347921041",0.992502742587568,1894,650,1244,238.960998914871
"0348021025",1.17702242126591,2268,818,1450,231.072386962011
"0348021053",1.53501404669126,2440,1095,1345,236.514517473472
"0348021055",0.300507671840072,848,91,757,246.544480175895
"0348421005",0.704933806041547,1488,384,1104,241.479455745078
"0348421014",1.37758700595805,2324,991,1333,236.724271441729
"0348421015",0.514807116916632,1424,239,1185,240.071140781065
"0348421017",1.05643650189208,1958,704,1254,238.707485564507
"0348421018",1.11385234878822,988,764,224,253.742683478764
"0348421021",0.3850106680349,1581,142,1439,232.155881650964
"0351821004",1.74149090880141,1464,1212,252,253.376313296165
"0351821008",0.667064647479517,1589,361,1228,239.279492477403
"0351821010",1.2889297606165,2016,915,1101,241.568467978365
"0351821014",0.962083531195998,1529,617,912,244.368326812601
"0351821019",3.7720705067591,2145,1586,559,249.20584837963
"0352221018",2.80110971359876,1564,1502,62,258.044220981525
"0352221029",2.37877593172901,1455,1403,52,258.596950321669
"0352221041",2.0574669039687,2035,1317,718,247.024918853716
"0352221042",2.02988361837904,1368,1311,57,258.27711703343
"0352221044",2.11237598943977,1499,1339,160,254.926287946429
"0360721016",1.4402813203088,1802,1033,769,246.395409448782
"0360721022",1.48967624433866,2452,1066,1386,234.766822588112
"0360721049",0.272867897841744,235,82,153,255.205739916154
"0360721054",0.401885679082762,891,158,733,246.822545952711
"0360721058",1.37613218549072,1949,990,959,243.69865942874
"0363521008",1.90149810259931,2644,1265,1379,235.126186165872
"0363521009",1.23956422878309,2198,876,1322,237.019983603022
"0363521015",1.11720930045977,1045,767,278,253.045917605748
"0363521019",1.0057729163742,1804,659,1145,240.759047676295
"0363521020",1.30184132479726,2264,926,1338,236.646632834192
"0363821002",1.19618139275749,2436,838,1598,179.789697586879
"0363821009",1.34766258178633,2321,968,1353,236.220431274178
"0363821021",0.0775293239904995,1234,5,1229,239.268831426494
"0364821002",0.886978949640466,1651,556,1095,241.677995628033
"0364821004",0.719687173986808,1707,403,1304,237.599425321799
"0364821015",0.772045705744663,1706,439,1267,238.493051824924
"0364821018",0.886457767866424,1459,555,904,244.441054550591
"0364821032",0.745289551057653,1036,420,616,248.513624275621
"0365221005",0.460967464130687,1723,193,1530,220.58020530416
"0365221007",0.564580271223039,1617,285,1332,236.739532215147
"0365221013",1.40091694151204,2518,1012,1506,224.28584651571
"0365221027",0.979770853380608,2187,635,1552,216.448490028024
"0365221030",2.17325527789247,2899,1354,1545,218.006010639255
"0365821004",2.48093066371802,2252,1433,819,245.801888188142
"0365821009",1.57999163744113,1750,1126,624,248.444633499391
"0365821015",2.42009266872703,1573,1417,156,255.121101107804
"0365821019",2.39810292118037,1802,1409,393,251.176260642136
"0365821020",2.16249715674604,2104,1350,754,246.552030175265
"0366021002",0.708381886141914,1246,393,853,245.281537755661
"0366021003",1.58570994634796,2376,1129,1247,238.875085615207
"0366021004",2.33518773506644,2785,1390,1395,234.540670405417
"0366021010",2.01793360684341,2577,1304,1273,238.300901800563
"0366021015",1.12741008203672,1723,778,945,243.878989675654
"0368021005",1.26877417851678,2101,899,1202,239.735677526383
"0368021007",0.255238161973026,1450,69,1381,235.0489857074
"0368021014",1.35695084289936,2513,977,1536,219.524232881601
"0368021015",2.21725194948769,2829,1365,1464,229.882012883928
"0368021030",1.46818057016386,2031,1049,982,243.402580083702
"0368721004",0.382919554235116,1279,139,1140,240.788461697459
"0368721009",0.34392747515332,1574,111,1463,229.903944736098
"0368721012",2.25644951674402,2432,1375,1057,242.255349043139
"0368721016",0.375140260530392,183,133,50,258.623672716379
"0368721021",1.22415907129696,1813,864,949,243.848266171816
"0368821003",0.90413337455766,1061,567,494,249.99066716483
"0368821004",0.48959962436247,598,214,384,251.210635859717
"0368821008",0.840486257097379,942,506,436,250.698479113684
"0368821010",2.17448048001603,1959,1355,604,248.644202438199
"0368821017",0.126531265848869,175,16,159,254.949020559893
"0377321002",1.39753673651348,1322,1007,315,252.476100633174
"0377321004",0.637355925668559,1011,337,674,247.70545526059
"0377321015",1.43285451078289,1069,1029,40,258.952854046417
"0377321055",2.02768106901861,1484,1310,174,254.626209680456
"0377321066",1.96079609419065,2031,1282,749,246.600420036337
"0377421002",2.98330045252977,1624,1533,91,256.829846876503
"0377421004",3.43964915638365,1848,1574,274,253.092705935847
"0377421008",1.43160647230502,1678,1028,650,248.049261776996
"0377421011",1.37141121140393,1778,986,792,246.052319952713
"0377421017",1.60509699231573,1208,1139,69,257.651481556308
"0379621001",1.39221268735652,1050,1002,48,258.647326776823
"0379621005",1.03365527016205,1423,684,739,246.734848381762
"0379621011",0.873544183330749,1793,540,1253,238.707937887936
"0379621016",0.625100651737544,1846,327,1519,223.263319028106
"0379621028",0.846308769886062,514,512,2,265.256053004476
"0380121003",1.67792004827592,1572,1177,395,251.119269503066
"0380121026",0.76042997590163,458,432,26,259.803430821926
"0380121046",2.68666284397965,1951,1475,476,250.21663656489
"0380121048",2.1034054949135,1476,1336,140,255.457077931318
"0380121065",0.930256468259605,839,592,247,253.444077716652
"0380321023",1.60047947428341,1461,1136,325,252.154510432386
"0380321024",1.36628343740279,1036,985,51,258.599893076319
"0380321026",1.61109169684395,1222,1145,77,257.284700389566
"0380321048",4.28083715998945,1928,1598,330,252.003027349835
"0380321052",1.40076050790286,1381,1010,371,251.355470618021
"0381321002",0.491277409435074,813,215,598,248.706865071849
"0381321003",1.07888714978889,791,719,72,257.616763265091
"0381321008",3.15587499641634,1566,1558,8,261.81937541336
"0381321009",1.42876839740303,1333,1027,306,252.645088166463
"0381321037",1.21569261946088,1178,852,326,252.106724619709
"0382421015",2.85340597536419,1805,1515,290,252.858362651816
"0382421018",2.00283169916017,1389,1300,89,256.83253516074
"0382421025",0.263013673606921,273,74,199,254.28660673063
"0382421033",1.28087816721771,930,910,20,260.545341104497
"0382421036",2.36787310269486,1421,1400,21,260.444050490019
"0382521008",2.69297986156249,1797,1478,319,252.286662596663
"0382521021",1.24516639683943,1246,880,366,251.388679095044
"0382521039",1.22074780567578,1290,860,430,250.765394555676
"0382521045",0.344486942986143,1268,112,1156,240.591308167486
"0382521048",2.33185776039934,2085,1389,696,247.377637430856
"0383321013",0.0830625464540806,421,6,415,250.924941575605
"0383321016",2.01602319480399,2327,1303,1024,242.724567676096
"0383321019",1.57053542433433,2208,1118,1090,241.770454783958
"0383321020",0.906585559594001,1146,571,575,249.046397544019
"0383321025",0.751342010491353,1347,424,923,244.176465004337
"0389621006",1.18750716447935,936,828,108,256.258879466419
"0389621007",1.23910089139346,1587,875,712,247.10347977506
"0389621009",1.21350543535697,2076,846,1230,239.26185388848
"0389621020",2.32675211637049,2749,1385,1364,235.867551094853
"0392921003",1.64308042451975,1327,1161,166,254.826846638135
"0392921014",2.2279466396875,2390,1368,1022,242.76556663573
"0392921019",0.437356659298129,1504,178,1326,236.980744138782
"0392921021",0.966430482198516,1060,621,439,250.627078099574
"0392921031",1.13238644896432,1757,783,974,243.516629686878
"0393021020",1.18682405881038,1201,826,375,251.31256222656
"0393021023",0.618769998690624,1353,321,1032,242.621817517565
"0393021024",0.391744485191877,1467,148,1319,237.090793267124
"0393021026",1.43891609063472,2424,1031,1393,234.556806494636
"0393121003",0.362145846429511,895,123,772,246.391808619056
"0393121022",0.456533890903706,1349,190,1159,240.584529237943
"0393121025",0.947335594303067,989,602,387,251.199318619857
"0393121027",1.18349920490101,1535,824,711,247.105799219505
"0393121034",0.251865046898782,688,66,622,248.456146441727
"0393221002",1.09468285591841,1726,740,986,243.267232641022
"0393221005",0.203668799451286,856,48,808,245.891182296304
"0393221013",0.172602618220243,1423,32,1391,234.65889423714
"0393221015",1.69650774719829,1705,1193,512,249.786866840156
"0418641040",0.920938874449734,1695,583,1112,241.34623791507
"0418641049",0.392867155162756,717,150,567,249.134171020464
"0418641062",0.716425138845077,1810,400,1410,233.878367762072
"0418641081",1.56405705345465,2695,1112,1583,205.501503331452
"0418641094",1.00723949591153,1766,660,1106,241.408033566948
"0444241032",0.539847029475807,1012,264,748,246.613095716218
"0444241052",0.36476917947022,185,125,60,258.187107641021
"0444241053",1.04703794711765,1199,696,503,249.905166723912
"0444241061",0.974993958915749,1074,631,443,250.598639006261
"0444241101",0.304303267959419,905,94,811,245.884648385771
"0459041032",1.68623500314514,2314,1184,1130,241.01472251997
"0459041061",0.32101987038685,550,101,449,250.501915095912
"0459041070",0.265021339010816,1530,75,1455,230.333771985719
"0459041079",1.49509274049871,1534,1069,465,250.335626600458
"0459041162",0.17100455858504,682,31,651,248.03697430368
"0496521001",1.49460172946038,1307,1068,239,253.533543487582
"0496521002",1.1262500755203,1149,775,374,251.322918487581
"0496521007",0.767435328569292,1535,436,1099,241.629190864797
"0496521010",0.656876475906422,414,351,63,258.042788807059
"0496521014",1.30941488329178,1559,939,620,248.488147680856
"0497121035",0.174840302151614,1405,33,1372,235.524405480528
"0497121043",1.84302103272048,2405,1245,1160,240.571567517566
"0497121044",2.32958393704986,2901,1388,1513,223.78314297527
"0497121045",3.65392798214436,3012,1581,1431,232.679160616006
"0497121049",1.21519675149078,2110,851,1259,238.63503394774
"0498721007",0.635299856280655,1179,336,843,245.358313549311
"0498721008",0.436399454313594,846,176,670,247.7704198905
"0498721015",0.240301500381132,1319,61,1258,238.646227570474
"0499921001",0.704875765364291,566,383,183,254.520278977401
"0499921004",1.54831037428122,2096,1099,997,243.114989074958
"0499921019",0.406754416830078,1331,164,1167,240.515434581057
"0499921025",0.303674336306746,1222,93,1129,241.015560703392
"0499921029",0.304989671999043,1375,96,1279,238.172248954956
"0501421011",1.98395430995172,1662,1293,369,251.358612619557
"0501421032",0.747757157930346,908,421,487,250.118273866771
"0501421034",1.29339187877418,1135,918,217,253.861467048589
"0501421042",1.4990140605777,1702,1071,631,248.364859684955
"0501421043",0.187097606404169,520,40,480,250.151813930103
"0501521029",1.0979058881886,2213,744,1469,229.091658787407
"0501521031",2.20863743608655,2809,1363,1446,231.565937887936
"0501521045",0.397136811184949,1456,154,1302,237.604500718623
"0501521051",0.821699225779203,1838,487,1351,236.264477871101
"0501521054",0.539396465335113,1214,263,951,243.770121930744
"0502021031",0.392106839695663,969,149,820,245.794720515801
"0502021041",0.88532812060065,1802,554,1248,238.807156141903
"0502021052",0.928237491463243,1969,591,1378,235.171928408219
"0502021053",1.28589697484505,1916,911,1005,243.066632873505
"0502021074",0.790192009629867,1217,457,760,246.503017393306
"0514621012",1.92645107870304,2023,1273,750,246.58671764984
"0514621020",0.826066462082012,1916,489,1427,232.822741018446
"0514621027",0.694318232852929,1877,375,1502,225.336955865326
"0514621029",0.751032075170331,1933,423,1510,224.0085683994
"0514621033",1.5543974422353,2124,1106,1018,242.851417639665
"0515221020",0.440136819561383,1245,180,1065,242.145335595166
"0515221048",0.966224891155579,1811,620,1191,240.041961597251
"0515221053",0.823242900875305,1359,488,871,244.978917488791
"0515221056",1.07562833488735,2099,715,1384,234.863356912131
"0515871018",1.09513368345187,1666,741,925,244.14888260211
"0515871022",0.165962551583525,1227,27,1200,239.794872119129
"0515871024",0.829225228946205,1551,492,1059,242.228675983173
"0515871028",0.593772815376226,1576,301,1275,238.277942096693
"0516121003",0.390712688178467,694,146,548,249.306820957112
"0516121004",1.22808528911696,1679,865,814,245.859311027936
"0516121007",1.0215339542879,1848,676,1172,240.457789379037
"0516121009",1.14029246294655,1373,788,585,248.892238335775
"0516121024",0.869431658236305,624,536,88,256.915300762714
"0516621005",0.832083639207319,820,496,324,252.169250594222
"0516621007",1.08320920730013,1360,726,634,248.327857959242
"0516621008",1.24330266598757,1003,879,124,255.81564880403
"0516621012",1.28072864337123,1394,909,485,250.120670575869
"0516621013",2.40524958158645,2191,1410,781,246.24033103131
"0516721011",1.58378558103368,1468,1128,340,251.876894678059
"0516721019",0.201043487927457,451,47,404,251.025830083702
"0516721021",0.135300788619206,253,18,235,253.639777835024
"0516721024",1.52897329809927,1726,1091,635,248.297769769984
"0516721026",0.479701041248208,772,206,566,249.136199351779
"0517021003",2.05931124308739,2286,1318,968,243.603735286524
"0517021005",0.536594823212597,874,260,614,248.545059610863
"0517021029",0.498062358946348,299,223,76,257.285365136613
"0517021030",2.41454353986755,2590,1413,1177,240.336505127794
"0517021034",0.797925995287498,2053,466,1587,202.826197495015
"0526541003",1.69648078687122,2361,1192,1169,240.49168557312
"0526541009",0.512267009390791,655,235,420,250.85100422746
"0526541017",0.37805869089302,406,137,269,253.129918804469
"0526541019",0.399106110543571,1202,155,1047,242.442594835102
"0528521002",0.199961033786338,203,45,158,255.04775733238
"0528521006",1.88840696540575,2485,1259,1226,239.326664499627
"0528521016",0.831942244584268,729,495,234,253.64372977506
"0528521019",0.772621145422207,1318,440,878,244.887273866771
"0528521020",1.30333986796396,2302,929,1373,235.482427788966
"0530021001",1.1953920474324,2010,837,1173,240.443193251714
"0530021013",0.8090622640445,1630,478,1152,240.663599263597
"0530021020",1.88446603250147,1443,1257,186,254.476689591479
"0530021025",0.783583007471025,949,451,498,249.972166584483
"0530021040",0.603547679669969,552,310,242,253.465644237141
"0532271001",1.17187441401757,1829,816,1013,242.925830965537
"0532271019",0.8109613256027,1353,479,874,244.969856779229
"0532271031",1.64324342387758,2114,1162,952,243.763943399399
"0532271032",0.522355428326273,753,244,509,249.827746850577
"0532271034",0.690347126156839,1051,373,678,247.670771181186
"0535871001",3.05468570131829,2996,1545,1451,230.960981823576
"0535871002",0.598068156248658,1362,304,1058,242.235906565862
"0535871015",2.58737617283067,2436,1455,981,243.420591567589
"0535871019",1.16431135332269,1505,810,695,247.400747411745
"0535871023",1.0767304213747,1468,717,751,246.576570824442
"0536571006",0.52372221708294,1431,245,1186,240.064365617612
"0536571017",2.38924216134152,2618,1406,1212,239.60353823666
"0536571021",0.539187407322391,1573,262,1311,237.314382111921
"0536571054",0.157500195739903,1581,26,1555,215.047201115447
"0536571064",0.0117124683983766,1406,1,1405,234.261390856926
"0536671025",0.376034997655213,595,134,461,250.401826115449
"0536671033",1.14430900384773,1168,792,376,251.292091026463
"0536671050",0.309241757358937,734,97,637,248.211669141854
"0536671056",0.664238346984282,1089,357,732,246.824872391703
"0536671060",1.75566220606207,2565,1216,1349,236.392740136612
"0537771001",0.738299406926283,1677,414,1263,238.530416282997
"0537771008",0.34956639941279,942,117,825,245.709395407187
"0537771030",0.326745093313278,630,103,527,249.639122411744
"0537771038",0.715701366587943,1078,398,680,247.645379025501
"0537771045",0.931446657579456,1258,593,665,247.816030921444
"0537871009",0.430269542221576,1405,173,1232,239.231963000169
"0537871023",0.791854771549023,1919,459,1460,230.204530440444
"0537871029",0.689353401553077,1621,372,1249,238.778785110158
"0537871042",0.361030324847931,1648,121,1527,221.044694723884
"0537871045",0.474199623422223,1010,204,806,245.909376660581
"0539971020",0.460419261473,705,192,513,249.786442958482
"0539971045",0.0220311431741997,359,2,357,251.54969018874
"0539971046",0.560152671860209,1413,282,1131,240.988376820915
"0539971068",1.23165782325855,1469,869,600,248.676349263596
"0539971075",0.327972650964918,951,104,847,245.314300101339
"0552371005",1.08002413476847,1875,721,1154,240.62389149143
"0552371026",0.87555394326082,1537,542,995,243.166286713492
"0552371028",0.265262064489152,1107,76,1031,242.625005268085
"0552371031",2.90569609147146,3099,1522,1577,208.603730877354
"0552371034",1.10210817581851,1752,751,1001,243.094097259427
"0552771005",0.597506614378061,1483,302,1181,240.228015692845
"0552771029",0.343490322383937,1475,110,1365,235.833323069111
"0552771031",0.861027612892353,1167,527,640,248.166015248846
"0552771032",0.495323118982771,1588,220,1368,235.683481097811
"0552771045",1.25011598531169,2014,887,1127,241.074603672768
"0554771014",1.03159682249262,1807,683,1124,241.117460234415
"0554771015",0.557153497326601,1597,280,1317,237.191361348733
"0554771022",0.489515166841096,1595,213,1382,235.019508812381
"0554771025",0.455263828609865,1500,188,1312,237.308583931706
"0554771028",1.02253280509845,2147,677,1470,228.909554029508
"0557971035",0.535740055258338,344,258,86,256.937435462891
"0557971039",0.671513041547954,1376,362,1014,242.905662789577
"0557971041",0.175137665347943,173,34,139,255.471215365087
"0557971072",0.586957047728763,952,294,658,247.901588060294
"0557971086",0.415070679590943,514,168,346,251.762581736308
"0559271018",1.23906134401628,2048,874,1174,240.4233866213
"0559271026",0.980165112542144,1364,636,728,246.905515268887
"0559271053",1.08810663603285,1650,734,916,244.289237050192
"0559271055",1.1155142088264,1729,765,964,243.67590002919
"0559271064",1.12672977313105,1329,777,552,249.284045271292
"0559671014",0.588534371111682,1173,297,876,244.912348161303
"0559671017",1.25133868424335,1843,889,954,243.728145660101
"0559671036",0.545674664449202,1073,268,805,245.929469814342
"0559671062",0.985557757804037,2077,643,1434,232.558230676937
"0559671068",0.736292776744345,1150,413,737,246.754512946354
"0681471001",1.30197319565873,2117,927,1190,240.04293259693
"0681471010",2.22338055090608,2825,1366,1459,230.217584492873
"0681471012",2.3270168796702,2932,1386,1546,217.916032244196
"0681471017",1.92453581733218,2436,1272,1164,240.544668175113
"0681471021",1.56971567537256,1542,1117,425,250.799335815625
"0683071016",0.0642640403882181,120,4,116,255.944042024539
"0683071018",1.35231354721251,2089,975,1114,241.301304410302
"0683071019",0.900532215320492,1592,564,1028,242.662469854426
"0683071036",0.396868188852842,1358,153,1205,239.70388102967
"0683071045",0.497141673753398,1000,222,778,246.267286974034
"0684771006",1.09067296811306,2014,737,1277,238.224962859877
"0684771007",1.02955299908672,1325,681,644,248.113253364125
"0684771009",1.30861165582419,2297,938,1359,236.143762324799
"0684771012",2.08726457535411,2812,1326,1486,226.929993443489
"0684771022",1.07669821202551,1546,716,830,245.63527377243
"0684971001",0.843095155375957,1200,508,692,247.467361452422
"0684971012",0.617075527781095,927,320,607,248.620919549792
"0684971020",0.224279079679892,859,56,803,245.932695143026
"0684971039",0.156957442708562,660,24,636,248.262821565986
"0684971040",1.39274160951013,2048,1003,1045,242.447728813059
"0686671004",1.59732506669164,2463,1134,1329,236.911935903808
"0686671007",1.94831331730611,2386,1278,1108,241.396212801293
"0686671014",0.958456009241903,1694,613,1081,241.9485320538
"0692071001",0.544490024333717,1128,267,861,245.129447147194
"0692071003",2.06078719577969,2857,1320,1537,219.4207024382
"0692071004",1.09678821072417,2063,743,1320,237.082515167138
"0692071012",1.95410275637327,1870,1279,591,248.792140709804
"0692071013",1.3133565523295,1269,942,327,252.081316194813
"0692971006",0.807205316907989,1389,471,918,244.262994435554
"0692971009",0.140511401725,1408,19,1389,234.663815473313
"0692971011",1.67846541659339,2166,1178,988,243.245336036083
"0692971023",0.462822268196317,871,195,676,247.677768355307
"0693571013",0.175742970194385,1032,36,996,243.155704049243
"0693571016",1.69212761454385,2090,1189,901,244.543982059812
"0693571178",1.15168371504314,1733,800,933,244.019224297467
"0693571187",1.92342036105831,1621,1271,350,251.720341206839
"0693571192",1.95655854839644,2190,1281,909,244.397537455035
"0694671009",1.69098836419507,2353,1188,1165,240.543570221337
"0694671018",0.983230154482687,1371,641,730,246.850033671628
"0694671027",1.03392257311823,1186,685,501,249.912316194813
"0694671045",0.879862221000827,805,546,259,253.291178032498
"0694671050",0.991511274673412,769,648,121,255.915588461127
"0695171013",0.856489355099137,1293,520,773,246.37916117231
"0695171020",1.22266767367925,1866,862,1004,243.067726688641
"0695171021",0.654330550886971,875,349,526,249.641270118976
"0695171025",0.920424624103218,2161,582,1579,207.109876966479
"0695171028",1.59225169098776,2619,1132,1487,226.860808258304
"0698271001",0.272122244887762,1383,80,1303,237.602375939081
"0698271004",0.0951721681081365,67,9,58,258.242676424091
"0698271031",0.86495507532256,738,531,207,254.070324772655
"0698271082",1.75911078916515,2548,1220,1328,236.941606759187
"0698271119",0.806583980017846,1305,470,835,245.548455524619
"0699171066",0.256272425352755,1136,70,1066,242.142617782114
"0699171098",1.37546691657789,1973,989,984,243.297370227201
"0699171148",0.556027660022581,629,278,351,251.709420251251
"0699171196",1.10630970848228,1748,755,993,243.177089807792
"0699171213",0.315960972428679,1407,98,1309,237.365165581537
"0700371004",0.927066166075968,1738,590,1148,240.696345315354
"0700371020",1.38022962194509,2149,992,1157,240.589365136612
"0700371059",0.568683997939076,1269,286,983,243.386626941166
"0700371068",0.789098580091505,1891,456,1435,232.406147984938
"0700371076",0.444117128092165,1115,181,934,243.997975806806
"0700571026",0.378261584132933,853,138,715,247.042255648878
"0700571030",1.75377579821141,2147,1215,932,244.028633214214
"0700571035",1.68094840568574,1607,1180,427,250.78282126536
"0700571073",1.16215241035648,1225,806,419,250.85972823185
"0700571079",0.939301698356407,1793,598,1195,239.939590665713
"0701171029",1.0914216892615,1798,738,1060,242.227756009628
"0701171035",1.6949703906909,2094,1191,903,244.500202048157
"0701171038",0.816186156005932,959,482,477,250.184993102782
"0701171042",0.546165903566644,1216,269,947,243.860655700986
"0701171060",1.30644830937828,1784,934,850,245.292657464654
"0701671006",1.05501818717656,1237,702,535,249.568065232812
"0701671007",0.47231931565475,661,202,459,250.415901632524
"0701671008",0.705235781009351,1107,385,722,246.988592850257
"0701671049",0.372432094982091,862,131,731,246.830893355307
"1439139101",2.33952621376615,1947,1392,555,249.251229364223
"1439139102",1.78706351691139,1756,1232,524,249.652920092435
"1505034901",0.716233932282015,1278,399,879,244.881367319834
"1505034902",1.44990949911808,2137,1040,1097,241.640192854207
"1507060401",0.66438088547122,1495,358,1137,240.89343585613
"1507060402",2.6950608981108,1811,1479,332,251.975803705091
"1507111601",2.33673782869617,2519,1391,1128,241.060506182486
"1507111602",2.47492648736757,1610,1432,178,254.603838466123
"1507111603",2.30574870442479,1688,1380,308,252.584416903357
"1520040001",1.30688528902463,2535,936,1599,179.211418483887
"1521053801",2.76510945263582,1576,1492,84,257.058901051013
"1521053802",1.84955236319799,1576,1247,329,252.006824916546
"1521053803",2.81520022853815,2053,1507,546,249.362509069278
"1521078201",1.01329119500726,1027,667,360,251.492088539065
"1521085901",2.61285699611228,2584,1462,1122,241.148311858445
"1522036401",1.50208274128073,1122,1075,47,258.686359659789
"1522036402",0.25331719931717,756,67,689,247.510691646514
"1524030001",2.5588993092051,2775,1452,1323,237.015269029105
"1529104101",2.5863085471812,2815,1454,1361,236.05750754026
"1529104102",3.14696157853539,1887,1556,331,251.999078869048
"1530118701",3.2618388538113,1715,1564,151,255.221514149831
"1533043301",3.3803088958285,2610,1572,1038,242.517936153659
"1533043302",1.69085788202514,2000,1187,813,245.873565656683
"1534072601",3.83675502420896,2023,1588,435,250.698535293494
"1544026401",0.840080926701051,2107,505,1602,177.461206715801
"1544083301",2.30935409059318,1928,1381,547,249.336664093246
"1544091701",4.32404421758378,2016,1600,416,250.924175608895
"1544092201",2.58939389692362,1604,1457,147,255.360015145337
"1544092202",0.695387696648739,627,377,250,253.403877060551
"1544092301",2.83081600858111,2361,1512,849,245.295610318355
"1602042701",1.08974897043737,1293,736,557,249.23701478861
"1602042702",1.47917093993908,1454,1057,397,251.099242833309
"1602050001",0.602405897901398,1105,308,797,245.999622542625
"1603075501",1.41420478268017,1234,1018,216,253.924481491242
"1603076501",2.52499469119093,2719,1443,1276,238.248772772875
"1603077601",2.50668903938121,1467,1438,29,259.534006783683
"1603077602",1.76002356073253,1504,1222,282,253.002361738197
"1603077603",2.64900459366208,2659,1470,1189,240.043726153824
"1604029001",1.98443499752179,1727,1294,433,250.704365295438
"1606038501",2.46987036550687,1938,1430,508,249.827939681329
"1606038602",2.70455880650355,1999,1482,517,249.739410244175
"1606042301",1.68616194995914,1555,1183,372,251.340368732232
"1608050901",2.30202286574513,1916,1379,537,249.533748866867
"1611167101",2.77825501648032,1917,1495,422,250.843542848251
"1612059301",2.40948360508083,1933,1411,522,249.68773780455
"1612059401",1.46059303256849,1117,1044,73,257.6141023674
"1616093501",2.61658751470701,1562,1463,99,256.53815188183
"1616093502",3.55783940380429,2598,1578,1020,242.806914391928
"1617070001",2.98139251899363,3107,1532,1575,209.204830630847
"1617071801",1.97496109740412,1805,1290,515,249.745246469519
"1617072101",1.49035658252609,1080,1067,13,261.104408015952
"1620088001",2.78410583791269,1633,1497,136,255.559516424532
"1620100301",0.598081751905857,621,305,316,252.41474730767
"1623040701",1.34020509658903,1140,963,177,254.614419033988
"1623040702",1.53149465089911,1411,1093,318,252.328062579074
"1623050201",4.36510214440095,1699,1601,98,256.59155705921
"1623050202",2.99339863381803,1551,1537,14,261.005492714238
"1623050203",2.63783108091487,1484,1466,18,260.631186372305
"1625061701",0.819465369842296,619,486,133,255.591916030961
"1626038301",4.21949202674988,2413,1596,817,245.804930604893
"1626039801",1.84306643482104,1610,1246,364,251.439255851433
"1626039802",2.44997481871299,1781,1423,358,251.527662125228
"1626041501",1.51244329750383,2147,1080,1067,242.129064464735
"1626041502",1.48501444763598,1179,1061,118,255.924313562208
"1627041801",1.62616152607013,1613,1155,458,250.417875639977
"1627041802",2.53636293892111,2407,1449,958,243.700472788643
"1627042701",2.60635882945486,2676,1461,1215,239.57068468533
"1628035901",2.80334785731256,1675,1503,172,254.720708672583
"1628036401",2.80875658314795,1814,1505,309,252.562611617452
"1628036402",2.44135980384861,1623,1421,202,254.190842742442
"1648000401",3.87089933803453,2705,1590,1115,241.284761516241
"1648000402",3.15093570668884,2325,1557,768,246.399273089255
"1648000403",2.31985416100087,2293,1383,910,244.375818791594
"1648000404",2.05101274364399,1768,1316,452,250.476657167075
"1648023201",1.21489970726806,1434,850,584,248.922330721996
"1648023202",0.509372807755446,1472,232,1240,239.082292962577
"1648023203",1.53800265025855,2439,1096,1343,236.528560116662
"1649006301",2.76454682347409,2945,1491,1454,230.534556773615
"1649033101",2.24659849957295,1760,1374,386,251.205092751212
"1649033201",0.51520897637451,467,240,227,253.726686443047
"1650040901",2.63807343893543,2890,1467,1423,233.427286120657
"1703010901",2.88144356911304,2831,1518,1313,237.240300923563
"1703010902",2.24322809691031,2781,1372,1409,233.959285164149
"1703011201",1.66269117490068,2511,1172,1339,236.59858242508
"1703011202",3.12571871597468,2823,1553,1270,238.460579573392
"1705046001",2.47460322098159,2130,1431,699,247.332121866619
"1707009901",1.02943915318427,1539,680,859,245.158173402361
"1707010201",2.43156143327405,2012,1419,593,248.76081363838
"1707012001",2.70885227351049,1901,1484,417,250.877815442467
"1707012002",2.16604777321697,2052,1351,701,247.315610319976
"1707016701",1.24549105955382,1062,881,181,254.552524023818
"1707016702",2.99083128121,1981,1536,445,250.543434280756
"1707017001",1.12654829902751,1497,776,721,246.989932489527
"1707018901",0.709504489209827,609,394,215,253.960870932449
"1707040301",3.63499111468303,2606,1579,1027,242.703244106771
"1707040302",2.4512871123972,2185,1424,761,246.497905721697
"1707046801",3.05208481522715,2472,1543,929,244.080327989574
"1707046802",3.03113194537459,2640,1542,1098,241.637553557586
"1708004701",1.88482240460556,2677,1258,1419,233.473069822228
"1708007701",1.10197011011286,1554,750,804,245.931710033842
"1709008801",1.6553094760678,1510,1168,342,251.836120437472
"1710010301",3.05700889999975,2431,1547,884,244.838647226444
"1714063401",2.70173856021281,2436,1480,956,243.70607279866
"1715076701",0.982866034003391,1007,640,367,251.384354699911
"1715076702",2.70343146129959,1779,1481,298,252.73351594396
"1715077301",2.85388757712211,2341,1517,824,245.720641386543
"1715077501",1.9079785542531,2664,1268,1396,234.43265055954
"1715101001",1.97307330917152,2511,1289,1222,239.385208251857
"1715102501",1.38352845554117,1348,995,353,251.65495162937
"1716038801",2.88940127802118,2327,1520,807,245.905981213145
"1716038802",3.1288675049222,1764,1554,210,254.043943350133
"1716040401",2.8368024650542,1962,1514,448,250.504824537917
"1716040402",0.996691332266137,1300,652,648,248.073397690014
"1716040501",2.5284123493617,2226,1444,782,246.227186229878
"1717015001",2.19090392182507,2718,1358,1360,236.066546007343
"1717015002",1.34161429483684,1827,964,863,245.086066883534
"1717018601",1.46678293492573,1528,1047,481,250.141144749501
"1717018602",3.97967249360434,2419,1592,827,245.650708085065
"1718075301",1.10037351019329,1757,748,1009,242.979550310254
"1718075302",2.66036701249666,1748,1473,275,253.085196967609
"1718076601",1.36147652859914,1481,981,500,249.934989159547
"1718076602",0.965335360173766,1335,619,716,247.03597388497
"1718078601",2.5339164060552,2132,1446,686,247.575720813731
"1718089501",3.77636621467646,2094,1587,507,249.83035775932
"1718089502",2.83671877410786,2182,1513,669,247.784633783957
"1719034002",1.99735515309604,2514,1298,1216,239.565493891407
"1722054401",3.2987513880951,2722,1567,1155,240.608513467353
"1722055601",2.08618632075092,1986,1325,661,247.882711427267
"1722055602",2.52494739993736,2094,1442,652,248.027321063617
"1725074101",2.19389664179468,1814,1359,455,250.44313629133
"1725076401",1.47385757532037,1216,1052,164,254.84853810637
"1725080501",4.51704202245637,2690,1602,1088,241.790992499764
"1728032601",3.00217981446921,2846,1539,1307,237.428596669378
"1728032602",3.33893757808549,2271,1569,702,247.275591608086
"1729049501",1.14552978302614,1897,795,1102,241.522922116197
"1729049502",1.52884328826074,1413,1090,323,252.185271278497
"1729049503",1.57214919416276,1748,1120,628,248.381476553605
"1729057302",2.79783282016397,2180,1501,679,247.654851573793
"1730049501",1.76238271297531,1908,1224,684,247.592214008473
"1731074801",1.89986149557852,1427,1264,163,254.870806605301
"1731074802",1.44795908915464,1250,1038,212,254.007573923222
"1732051401",2.77798185608567,2574,1494,1080,241.958063607276
"1732096401",3.18516769649689,2058,1562,496,249.977770781646
"1732096601",2.1029965985303,2606,1335,1271,238.336331778371
"1732100701",3.7136629959537,2653,1584,1069,242.06767635463
"1732100702",1.01932438441351,1461,672,789,246.087286611449
"1732109701",2.09768277064799,2310,1330,980,243.427088815807
"1732109702",4.04861598530014,2486,1594,892,244.627977185347
"1733010401",3.84269342037987,2672,1589,1083,241.940101514253
"1733010402",2.37131753025588,2213,1401,812,245.880778066633
"1733046901",2.34938402072408,2373,1396,977,243.496113673942
"1733046902",0.997477880415287,1053,653,400,251.07066838396
"1733059501",1.66794156973761,1764,1176,588,248.826741468852
"1733084101",3.0528027779727,2771,1544,1227,239.301991112502
"1733086801",2.19641149131527,2080,1360,720,247.019455722147
"1733094901",2.76750181316137,2516,1493,1023,242.757981903028
"1734098701",3.05593659913152,2553,1546,1007,242.999346483199
"1734176701",2.04543141166211,2370,1315,1055,242.282504392006
"1736005301",1.66119876257892,1276,1171,105,256.347450673321
"1736005302",1.83728935682267,2108,1242,866,245.05117510157
"1737016001",2.45878578372221,2295,1428,867,245.038403826177
"1737100101",2.49933536261943,2179,1436,743,246.696410057324
"1737100102",2.09084091876743,1982,1327,655,248.002402065752
"1738040701",1.32955670922748,2310,955,1355,236.17769564793
"1738040702",1.06101211496451,2206,708,1498,225.952314464079
"1738041501",2.09277317160237,1977,1328,649,248.051555873266
"1738041503",2.63368403950469,2009,1465,544,249.407899597354
"1738044701",2.12411978640124,2317,1341,976,243.502526138674
"1738050101",1.78551071256362,1482,1231,251,253.37720231041
"1738050102",2.41122635757538,2254,1412,842,245.376759782961
"1738052201",3.17822353410774,2447,1560,887,244.727733657486
"1738053301",1.28060392777739,1121,908,213,253.993517494181
"1738053302",2.65476261428762,2492,1471,1021,242.788193794085
"1739047901",0.96790695614695,770,622,148,255.285397430018
"1739048301",1.32422856529779,1370,952,418,250.869631921916
"1739048302",1.25501152781413,1993,890,1103,241.512647170139
"1739067301",0.188367437135643,1356,42,1314,237.215022084226
"1739161801",2.74888931848613,2057,1488,569,249.094632233598
"1740049201",2.12716749195469,1705,1342,363,251.466790503743
"1740049202",1.05950040963371,785,706,79,257.267631320173
"1741000401",1.95562888965033,2136,1280,856,245.195722026
"1741001101",1.72204000865486,2312,1207,1105,241.422396125017
"1741001401",0.33672477087682,311,108,203,254.159628871488
"1741001901",2.32284453824398,1996,1384,612,248.56301913782
"1741001902",0.949609105500941,1440,604,836,245.543484196575
"1741011701",2.45242566108501,1617,1426,191,254.41848208174
"1741085001",2.38165894239603,2537,1404,1133,240.982399187308
"1742011901",1.61225500764818,2342,1146,1196,239.938879439586
"1742012201",1.49536456785902,1840,1070,770,246.393448951002
"1742012202",1.61693112158016,1866,1149,717,247.029776846866
"1742013101",1.22395718312487,1505,863,642,248.158875920748
"1742013102",1.27026339473598,1171,901,270,253.126376868885
"1742013901",0.45604721068866,794,189,605,248.639993784897
"1742014201",0.78268360592599,1566,449,1117,241.210800652849
"1742014202",0.34809437641505,1069,116,953,243.754530677621
"1742014203",1.16912256448483,1846,811,1035,242.570397659731
"1742016202",1.59856978667985,2667,1135,1532,219.936017063958
"1742022301",2.64665880669556,1879,1469,410,250.981260179269
"1742022302",2.89899063979189,2331,1521,810,245.886427665151
"1742053601",1.52739295373226,2079,1088,991,243.239435153742
"1743025801",1.23260878647348,1400,870,530,249.612921394519
"1744013901",2.39758557355199,1876,1408,468,250.293445932004
"1744039601",1.72090865378881,1587,1205,382,251.223385222469
"1744049301",2.53339042267405,1464,1445,19,260.630346210704
"1744049302",2.15605814724984,1688,1347,341,251.849329111583
"1744061801",0.665392249105847,1774,359,1415,233.606842379793
"1745066501",0.819297897420638,890,484,406,250.998918389468
"1748111201",2.23422633502747,2052,1371,681,247.637092004192
"1749113001",1.96731855204772,2847,1287,1560,213.967513923877
"9003961005",0.372167561892486,296,129,167,254.822555612803
"9003961007",0.46247923707842,1273,194,1079,241.965517693931
"9003961038",0.847458237651981,1181,513,668,247.794492782115
"9003961042",0.875350504975965,1742,541,1201,239.737135478925
"9101621006",0.487618566491801,1478,212,1266,238.502250718623
"9101621011",0.245021578265488,1162,62,1100,241.585307536805
"9101621018",1.24074853570483,2381,877,1504,224.872244545783
"9101621044",0.513756330225387,1442,236,1206,239.698252482292
"9101621052",1.09918618933239,2052,746,1306,237.443090405171
"9101821017",1.46087813565032,1982,1045,937,243.954439646842
"9101821020",2.34112597896182,1428,1394,34,259.326796405405
"9101821036",1.30541882129565,1386,932,454,250.45878498627
"9101821037",1.2740179378069,1283,903,380,251.241528636531
"9101821038",1.48772518525104,1258,1065,193,254.364080303038
"9106021012",1.05076898827567,1046,699,347,251.755291944372
"9106021015",0.622149735400161,895,324,571,249.076188108394
"9106021031",1.1691530548825,1427,812,615,248.540629686877
"9106021034",0.620802995508147,944,323,621,248.457339181103
"9106021035",0.969917544734478,828,624,204,254.136129907335
"9106521024",2.14445252533612,1422,1344,78,257.279743744423
"9106521033",1.35151769021532,1634,972,662,247.87251934994
"9106521034",0.865816999138389,1171,532,639,248.180739598365
"9106521042",1.59598523703711,1546,1133,413,250.931526026848
"9106521055",2.82837946264986,1744,1511,233,253.645097823473
"9107121003",1.73003917434556,1802,1208,594,248.760614257175
"9107121009",4.08980832947604,1841,1595,246,253.444109247521
"9107121086",2.67361198089242,1802,1474,328,252.01236984505
"9107121093",3.50401316639936,1861,1575,286,252.919137692751
"9107121098",2.55092604020731,2339,1450,889,244.712757574458
"9107421036",0.56227571312993,1262,283,979,243.437414078411
"9107421042",1.08703111810711,2169,732,1437,232.273764813768
"9107421059",1.21057022468341,2336,845,1491,226.475814872062
"9107421061",1.1596609884915,2287,805,1482,227.211008003427
"9107421076",1.76352557517008,2561,1225,1336,236.670256900093
"9107821018",1.29764457126046,1049,922,127,255.687109957442
"9107821052",4.31073516752101,1825,1599,226,253.727644905687
"9107821065",0.785289338226578,988,452,536,249.5380832459
"9107821070",2.20562496350508,1653,1361,292,252.794990895903
"9107821072",2.15730620429269,1438,1348,90,256.830525039094
"9108821020",1.53291442459287,1946,1094,852,245.289019817126
"9108821022",0.457164515808755,600,191,409,250.990237548464
"9108821023",2.36474188553635,2318,1398,920,244.226907359225
"9108821027",1.79531097627248,1479,1236,243,253.462749071047
"9108821078",1.69969385676701,1712,1196,516,249.744759301625
"9109921005",3.06053369236299,2475,1548,927,244.100162731175
"9109921007",3.17455878328899,1703,1559,144,255.405944519601
"9109921008",2.38813821709636,1766,1405,361,251.489507275132
"9109921010",1.21811698738192,1676,854,822,245.733496729423
"9109921026",1.14664277418106,2088,796,1292,237.927619613182
"9110821008",2.02055423448317,1525,1306,219,253.825318205819
"9110821017",0.818485262812048,1001,483,518,249.738142916055
"9110821045",0.88327130154721,1442,552,890,244.703883642381
"9110821048",1.50966269384695,1835,1079,756,246.54801004248
"9110821051",2.68783103825862,2223,1476,747,246.64410303765
"9111821010",0.782905138153956,2050,450,1600,178.64281512616
"9111821015",1.08507307093566,2333,730,1603,168.095080676333
"9111821034",0.245748609734052,1648,63,1585,203.817992453261
"9111821038",1.66360279291465,2767,1173,1594,189.318581946805
"9111821053",0.55201703943836,898,275,623,248.450961256542
"9112221004",0.228589380565147,1141,57,1084,241.910522323561
"9112221005",0.815477542475924,1930,481,1449,231.090500057247
"9112221015",0.769843340562884,1844,437,1407,234.077212611626
"9112221027",0.851665475230088,1072,518,554,249.25790503961
"9300171008",1.17841371791933,944,821,123,255.841373293579
"9300171010",2.24448197593962,2634,1373,1261,238.619319922567
"9300171018",0.983544542685836,830,642,188,254.451282023737
"9300171022",1.3894941494033,2246,1000,1246,238.922984184232
"9300171028",0.37167801638997,1513,128,1385,234.78597362298
"9300971002",1.02900980135059,1266,679,587,248.872793139165
"9300971008",1.10914969260408,1481,756,725,246.9449859479
"9300971027",1.76080931394764,1262,1223,39,258.997837018126
"9301471008",1.61458755513198,2698,1147,1551,216.491032023738
"9301471024",0.981988058609282,2129,639,1490,226.521588470979
"9301471071",0.832479873926886,1927,498,1429,232.750603877583
"9301471085",2.5581240583404,2951,1451,1500,225.755316528869
"9301471087",1.054744671713,2216,701,1515,223.551110479153
"9301671005",0.742892477248808,1273,418,855,245.195885859716
"9301671008",0.819402887255853,1265,485,780,246.24587146089
"9301671175",1.05511577968641,1715,703,1012,242.938032977025
"9301671185",0.0940771644100615,492,8,484,250.121891351139
"9913640666",1.22078940970447,2147,861,1286,238.027212799752
"9913660556",1.36580348768747,2053,983,1070,242.065704422327
"9916120485",0.912866250675086,2051,576,1475,228.393435831135
"9916120486",0.974861458357217,1509,629,880,244.878554730969
"9916131458",1.29459221375337,2046,921,1125,241.094820383526
"9916440180",0.840813552659261,1544,507,1037,242.556100927056
"9916440181",1.23001780424173,1699,866,833,245.581722059011
"9999901001",0.597576154866529,680,303,377,251.2672456039
